AAAAAAGCAGT -> AAAAAGCAGTT
AAAAAATAGCT -> AAAAATAGCTC
AAAAACTTACA -> AAAACTTACAA
AAAAAGCAGTT -> AAAAGCAGTTA
AAAAAGTATGC -> AAAAGTATGCA
AAAAATAGCTC -> AAAATAGCTCC
AAAAATGGTGA -> AAAATGGTGAG
AAAACCGGGCG -> AAACCGGGCGC
AAAACTTACAA -> AAACTTACAAG
AAAAGCAGTTA -> AAAGCAGTTAA
AAAAGTATGCA -> AAAGTATGCAT
AAAATACGTCA -> AAATACGTCAT
AAAATAGCTCC -> AAATAGCTCCT
AAAATGGTGAG -> AAATGGTGAGC
AAACCGGGCGC -> AACCGGGCGCC
AAACGGTCCCT -> AACGGTCCCTT
AAACTAGGCTC -> AACTAGGCTCT
AAACTTACAAG -> AACTTACAAGC
AAAGACCGAGG -> AAGACCGAGGG
AAAGACTCTCA -> AAGACTCTCAG
AAAGACTCTCC -> AAGACTCTCCT
AAAGCAGTTAA -> AAGCAGTTAAG
AAAGCATACAT -> AAGCATACATC
AAAGCCCTGCA -> AAGCCCTGCAG
AAAGCCGACGC -> AAGCCGACGCT
AAAGGGCCTCA -> AAGGGCCTCAG
AAAGTATGCAT -> AAGTATGCATG
AAAGTGAAAAA -> AAGTGAAAAAA
AAAGTGGTATC -> AAGTGGTATCA
AAATAACTCTG -> AATAACTCTGA
AAATACGTCAT -> AATACGTCATA
AAATAGCTCCT -> AATAGCTCCTC
AAATAGTACCT -> AATAGTACCTT
AAATGCCCAAT -> AATGCCCAATA
AAATGGTGAGC -> AATGGTGAGCA
AAATGTCCAGG -> AATGTCCAGGA
AAATGTCCTGT -> AATGTCCTGTA
AACACGGATTG -> ACACGGATTGC
AACAGCGAATA -> ACAGCGAATAC
AACCCGCTATC -> ACCCGCTATCG
AACCGCATCCC -> ACCGCATCCCT
AACCGGGATGT -> ACCGGGATGTT
AACCGGGCGCC -> ACCGGGCGCCC
AACCTTATAAT -> ACCTTATAATA
AACCTTCGCGT -> ACCTTCGCGTG
AACGAGACACC -> ACGAGACACCG
AACGAGTATTG -> ACGAGTATTGA
AACGATCTATA -> ACGATCTATAA
AACGCGGGTTA -> ACGCGGGTTAT
AACGCTTATTT -> ACGCTTATTTA
AACGGCAGGGA -> ACGGCAGGGAC
AACGGCCTGCG -> ACGGCCTGCGA
AACGGTCCCTT -> ACGGTCCCTTG
AACGGTTATGT -> ACGGTTATGTT
AACTACACGTG -> ACTACACGTGG
AACTAGGCTCT -> ACTAGGCTCTA
AACTCTGAGCG -> ACTCTGAGCGT
AACTTACAAGC -> ACTTACAAGCT
AACTTGAGTGA -> ACTTGAGTGAG
AAGAAATGTCC -> AGAAATGTCCT
AAGACCGAGGG -> AGACCGAGGGT
AAGACTCTCAG -> AGACTCTCAGC
AAGACTCTCCT -> AGACTCTCCTA
AAGAGACAAAG -> AGAGACAAAGA
AAGATCTTATA -> AGATCTTATAA
AAGCAGTTAAG -> AGCAGTTAAGC
AAGCATACATC -> AGCATACATCT
AAGCCCTGCAG -> AGCCCTGCAGT
AAGCCGACGCT -> AGCCGACGCTC
AAGCCGTCAAC -> AGCCGTCAACG
AAGCGCTGTTT -> AGCGCTGTTTG
AAGCTGCCTAT -> AGCTGCCTATC
AAGGATAGCGG -> AGGATAGCGGA
AAGGCCGGCTG -> AGGCCGGCTGC
AAGGGCCTCAG -> AGGGCCTCAGA
AAGTAATGTTG -> AGTAATGTTGC
AAGTATGCATG -> AGTATGCATGG
AAGTGAAAAAA -> AGTGAAAAAAT
AAGTGGTATCA -> AGTGGTATCAA
AAGTGTAGAGG -> AGTGTAGAGGT
AATAACCCGCT -> ATAACCCGCTA
AATAACTCTGA -> ATAACTCTGAG
AATAATTCCTT -> ATAATTCCTTT
AATACCACGGG -> ATACCACGGGG
AATACGTCATA -> ATACGTCATAA
AATACTTGAGT -> ATACTTGAGTT
AATAGCTCCTC -> ATAGCTCCTCT
AATAGCTGAGG -> ATAGCTGAGGA
AATAGTACCTT -> ATAGTACCTTT
AATAGTATATC -> ATAGTATATCT
AATCAATGCAA -> ATCAATGCAAA
AATCCGCAGAG -> ATCCGCAGAGG
AATCCTGGCAT -> ATCCTGGCATC
AATCGTATTAG -> ATCGTATTAGA
AATCGTGCAGG -> ATCGTGCAGGC
AATCTATCCGC -> ATCTATCCGCT
AATCTCCCCGG -> ATCTCCCCGGC
AATCTTATGGA -> ATCTTATGGAC
AATGCAAAAAT -> ATGCAAAAATG
AATGCCCAATA -> ATGCCCAATAA
AATGGTGAGCA -> ATGGTGAGCAC
AATGTCACTCG -> ATGTCACTCGA
AATGTCCAGGA -> ATGTCCAGGAA
AATGTCCTGTA -> ATGTCCTGTAG
AATGTTGCTAG -> ATGTTGCTAGG
AATTAGGAGCC -> ATTAGGAGCCT
AATTATAAAGC -> ATTATAAAGCC
AATTCATTTAT -> ATTCATTTATG
AATTCCATCTA -> ATTCCATCTAA
AATTCCTTTTC -> ATTCCTTTTCA
AATTCGATGTT -> ATTCGATGTTG
AATTCTGTTAG -> ATTCTGTTAGG
AATTGCAAGCG -> ATTGCAAGCGC
AATTGTTCGGC -> ATTGTTCGGCA
AATTTGCAGTT -> ATTTGCAGTTT
AATTTTGAGAG -> ATTTTGAGAGA
ACAAAGACCGA -> CAAAGACCGAG
ACAAGATCTTA -> CAAGATCTTAT
ACAAGCTGCCT -> CAAGCTGCCTA
ACACACTCTAT -> CACACTCTATT
ACACCGAATTC -> CACCGAATTCG
ACACCTGCCCA -> CACCTGCCCAG
ACACGCCGCTA -> CACGCCGCTAA
ACACGGATTGC -> CACGGATTGCG
ACACGTGGGAC -> CACGTGGGACT
ACACTCTATTC -> CACTCTATTCT
ACAGACTGTGT -> CAGACTGTGTT
ACAGCGAATAC -> CAGCGAATACC
ACAGCGTAGGG -> CAGCGTAGGGT
ACAGCTGGACA -> CAGCTGGACAC
ACAGGACTTCG -> CAGGACTTCGT
ACATACTGTAA -> CATACTGTAAT
ACATCTAATCA -> CATCTAATCAA
ACATCTCATGT -> CATCTCATGTT
ACATTGTGCAT -> CATTGTGCATC
ACATTTACTGA -> CATTTACTGAG
ACCAATCGTGC -> CCAATCGTGCA
ACCACAAGATC -> CCACAAGATCT
ACCACGGGGGG -> CCACGGGGGGG
ACCAGTCCTGG -> CCAGTCCTGGC
ACCCAAAGTGA -> CCCAAAGTGAA
ACCCAAGTGTA -> CCCAAGTGTAG
ACCCAGTCCAA -> CCCAGTCCAAG
ACCCCCCTCTG -> CCCCCCTCTGT
ACCCGCTATCG -> CCCGCTATCGA
ACCGAATTCGA -> CCGAATTCGAT
ACCGAGGGTGC -> CCGAGGGTGCA
ACCGCATCCCT -> CCGCATCCCTC
ACCGCCAGCTG -> CCGCCAGCTGC
ACCGGAATGTC -> CCGGAATGTCA
ACCGGCTGGCG -> CCGGCTGGCGC
ACCGGGATGTT -> CCGGGATGTTC
ACCGGGCGCCC -> CCGGGCGCCCC
ACCGTCTCATG -> CCGTCTCATGC
ACCGTGGCTAC -> CCGTGGCTACT
ACCGTTGCCAA -> CCGTTGCCAAC
ACCTAGAGTTA -> CCTAGAGTTAG
ACCTAGTCAAC -> CCTAGTCAACG
ACCTGCCCAGT -> CCTGCCCAGTG
ACCTTATAATA -> CCTTATAATAC
ACCTTATATAT -> CCTTATATATC
ACCTTCGCGTG -> CCTTCGCGTGC
ACCTTTATTCA -> CCTTTATTCAA
ACGAAATGTCC -> CGAAATGTCCA
ACGAATCTTAT -> CGAATCTTATG
ACGAGACACCG -> CGAGACACCGA
ACGAGTATTGA -> CGAGTATTGAT
ACGATCTATAA -> CGATCTATAAA
ACGATGTTCTC -> CGATGTTCTCG
ACGATTCCATG -> CGATTCCATGA
ACGCATACGTC -> CGCATACGTCA
ACGCCGCTAAC -> CGCCGCTAACC
ACGCGGGTTAT -> CGCGGGTTATA
ACGCTCATGCC -> CGCTCATGCCA
ACGCTTATTTA -> CGCTTATTTAA
ACGGATTGCGC -> CGGATTGCGCT
ACGGCAATTGT -> CGGCAATTGTT
ACGGCAGGGAC -> CGGCAGGGACC
ACGGCCTGCGA -> CGGCCTGCGAG
ACGGGAGGAGA -> CGGGAGGAGAT
ACGGGGGGGTA -> CGGGGGGGTAG
ACGGGTCCTCA -> CGGGTCCTCAG
ACGGTCCCTTG -> CGGTCCCTTGT
ACGGTTATGTT -> CGGTTATGTTC
ACGTCACATTT -> CGTCACATTTA
ACGTCAGACAA -> CGTCAGACAAC
ACGTCATAACC -> CGTCATAACCT
ACGTCCGGATA -> CGTCCGGATAC
ACGTGGCTTAC -> CGTGGCTTACA
ACGTGGGACTT -> CGTGGGACTTT
ACGTTCTTCCT -> CGTTCTTCCTT
ACTAACACGGA -> CTAACACGGAT
ACTAATTCCAT -> CTAATTCCATC
ACTACACGTGG -> CTACACGTGGG
ACTACCGTGGC -> CTACCGTGGCT
ACTAGCCTAAA -> CTAGCCTAAAG
ACTAGGCTCTA -> CTAGGCTCTAG
ACTCATGTGCT -> CTCATGTGCTG
ACTCCAAAGCC -> CTCCAAAGCCC
ACTCCCTGAGA -> CTCCCTGAGAA
ACTCGAATCTA -> CTCGAATCTAT
ACTCGATCCAA -> CTCGATCCAAA
ACTCGCGAATC -> CTCGCGAATCT
ACTCGTACGAT -> CTCGTACGATT
ACTCTATTCTG -> CTCTATTCTGT
ACTCTCAGCGT -> CTCTCAGCGTC
ACTCTCCTAGA -> CTCTCCTAGAC
ACTCTGAGCGT -> CTCTGAGCGTC
ACTCTTTACAT -> CTCTTTACATA
ACTGAACGAGA -> CTGAACGAGAC
ACTGAGTACAC -> CTGAGTACACG
ACTGCGGAAGA -> CTGCGGAAGAG
ACTGTAATTCA -> CTGTAATTCAT
ACTGTGTTCTA -> CTGTGTTCTAC
ACTGTTCCAGT -> CTGTTCCAGTG
ACTTACAAGCT -> CTTACAAGCTG
ACTTCGCAAAA -> CTTCGCAAAAA
ACTTCGTATGT -> CTTCGTATGTG
ACTTGAGTGAG -> CTTGAGTGAGC
ACTTGAGTTCA -> CTTGAGTTCAT
ACTTTCGGTTA -> CTTTCGGTTAG
AGAAAATACGT -> GAAAATACGTC
AGAAATGTCCT -> GAAATGTCCTG
AGAACGATCTA -> GAACGATCTAT
AGAATCGTATT -> GAATCGTATTA
AGAATTAGGAG -> GAATTAGGAGC
AGACAAAGACC -> GACAAAGACCG
AGACACACTCT -> GACACACTCTA
AGACACCGAAT -> GACACCGAATT
AGACATTGTGC -> GACATTGTGCA
AGACCACAAGA -> GACCACAAGAT
AGACCCAAGTG -> GACCCAAGTGT
AGACCGAGGGT -> GACCGAGGGTG
AGACCGCCAGC -> GACCGCCAGCT
AGACGTCCGGA -> GACGTCCGGAT
AGACTAACACG -> GACTAACACGG
AGACTCCCTGA -> GACTCCCTGAG
AGACTCTCAGC -> GACTCTCAGCG
AGACTCTCCTA -> GACTCTCCTAG
AGACTGTGTTC -> GACTGTGTTCT
AGAGACAAAGA -> GAGACAAAGAC
AGAGACTCCCT -> GAGACTCCCTG
AGAGAGATGTT -> GAGAGATGTTC
AGAGATCTCTG -> GAGATCTCTGA
AGAGATGTTCC -> GAGATGTTCCC
AGAGGGCCTTG -> GAGGGCCTTGG
AGAGGTTCACG -> GAGGTTCACGG
AGAGTTAGATG -> GAGTTAGATGG
AGATAAAGGGC -> GATAAAGGGCC
AGATAGATAAA -> GATAGATAAAG
AGATATAAAGT -> GATATAAAGTG
AGATCTCTGAT -> GATCTCTGATC
AGATCTTATAA -> GATCTTATAAC
AGATGGATTGA -> GATGGATTGAA
AGATGTCGCAG -> GATGTCGCAGA
AGATGTTCCCC -> GATGTTCCCCG
AGCACAGGACT -> GCACAGGACTT
AGCACCAGTCC -> GCACCAGTCCT
AGCAGCCCCCC -> GCAGCCCCCCA
AGCAGTTAAGC -> GCAGTTAAGCC
AGCATACATCT -> GCATACATCTA
AGCCACTAGCC -> GCCACTAGCCT
AGCCCCCCAGT -> GCCCCCCAGTA
AGCCCTGCAGT -> GCCCTGCAGTT
AGCCGACGCTC -> GCCGACGCTCA
AGCCGTCAACG -> GCCGTCAACGA
AGCCTAAAGAC -> GCCTAAAGACT
AGCCTTGACCG -> GCCTTGACCGT
AGCGAATACCA -> GCGAATACCAC
AGCGCGTCTCG -> GCGCGTCTCGT
AGCGCTGTTTG -> GCGCTGTTTGA
AGCGGATCCTA -> GCGGATCCTAC
AGCGGGTTCTC -> GCGGGTTCTCT
AGCGTAGGGTT -> GCGTAGGGTTC
AGCGTCAAACT -> GCGTCAAACTA
AGCGTCATGGC -> GCGTCATGGCG
AGCTCCTCTCG -> GCTCCTCTCGG
AGCTGAGGATC -> GCTGAGGATCC
AGCTGCCCCGC -> GCTGCCCCGCT
AGCTGCCTATC -> GCTGCCTATCA
AGCTGGACACC -> GCTGGACACCT
AGCTGGACTCA -> GCTGGACTCAT
AGCTTCTTGTA -> GCTTCTTGTAC
AGGAAAGCATA -> GGAAAGCATAC
AGGAAATAGTA -> GGAAATAGTAC
AGGAACTACAC -> GGAACTACACG
AGGACCTAGTC -> GGACCTAGTCA
AGGACGGCAAT -> GGACGGCAATT
AGGACTTCGTA -> GGACTTCGTAT
AGGAGATGTCG -> GGAGATGTCGC
AGGAGCCTTGA -> GGAGCCTTGAC
AGGATAGCGGA -> GGATAGCGGAT
AGGATCCTAGT -> GGATCCTAGTA
AGGATCTGTAT -> GGATCTGTATG
AGGCCGATACT -> GGCCGATACTC
AGGCCGGCTGC -> GGCCGGCTGCG
AGGCGCGGATT -> GGCGCGGATTC
AGGCGTCATCA -> GGCGTCATCAG
AGGCTCTAGTT -> GGCTCTAGTTC
AGGGACCGGCT -> GGGACCGGCTG
AGGGCCAGGAC -> GGGCCAGGACG
AGGGCCTCAGA -> GGGCCTCAGAA
AGGGCCTTGGA -> GGGCCTTGGAC
AGGGTGCAGAT -> GGGTGCAGATA
AGGGTGCTAGT -> GGGTGCTAGTT
AGGGTTCGGTC -> GGGTTCGGTCC
AGGTCATCGGG -> GGTCATCGGGC
AGGTCGCTCAG -> GGTCGCTCAGC
AGGTGTAACGG -> GGTGTAACGGT
AGGTGTCACTC -> GGTGTCACTCC
AGGTTCACGGG -> GGTTCACGGGA
AGTAATAGTAT -> GTAATAGTATA
AGTAATGTTGC -> GTAATGTTGCT
AGTACACGCCG -> GTACACGCCGC
AGTACAGCTGG -> GTACAGCTGGA
AGTACCTTTAT -> GTACCTTTATT
AGTATATCTGT -> GTATATCTGTC
AGTATGCATGG -> GTATGCATGGA
AGTATGGAGGT -> GTATGGAGGTC
AGTATTGATAT -> GTATTGATATT
AGTATTTCCCT -> GTATTTCCCTT
AGTCAACGCTT -> GTCAACGCTTA
AGTCAGTTCCA -> GTCAGTTCCAG
AGTCCAAGTAA -> GTCCAAGTAAT
AGTCCTGGCCG -> GTCCTGGCCGG
AGTGAAAAAAT -> GTGAAAAAATA
AGTGAGCACCA -> GTGAGCACCAG
AGTGCTTAATC -> GTGCTTAATCC
AGTGGAATCCG -> GTGGAATCCGC
AGTGGTATCAA -> GTGGTATCAAC
AGTGTAGAGGT -> GTGTAGAGGTT
AGTGTCGGATG -> GTGTCGGATGA
AGTGTGATTGG -> GTGTGATTGGC
AGTTAAAACCG -> GTTAAAACCGG
AGTTAAGCCGT -> GTTAAGCCGTC
AGTTAATTCTG -> GTTAATTCTGT
AGTTAGATGGA -> GTTAGATGGAT
AGTTAGGCGCG -> GTTAGGCGCGG
AGTTCAGAGAG -> GTTCAGAGAGA
AGTTCATGATT -> GTTCATGATTC
AGTTCCAGCAG -> GTTCCAGCAGC
AGTTCCTGCAC -> GTTCCTGCACC
AGTTCTATGAT -> GTTCTATGATC
AGTTCTTTCGG -> GTTCTTTCGGG
AGTTTCGTCAT -> GTTTCGTCATT
AGTTTTCATTG -> GTTTTCATTGC
ATAAAGACTCT -> TAAAGACTCTC
ATAAAGCCGAC -> TAAAGCCGACG
ATAAAGGGCCT -> TAAAGGGCCTC
ATAAAGTGGTA -> TAAAGTGGTAT
ATAAATAACTC -> TAAATAACTCT
ATAACAGCGAA -> TAACAGCGAAT
ATAACCCGCTA -> TAACCCGCTAT
ATAACCTTATA -> TAACCTTATAA
ATAACTCTGAG -> TAACTCTGAGC
ATAATACTTGA -> TAATACTTGAG
ATAATAGCTGA -> TAATAGCTGAG
ATAATTCCTTT -> TAATTCCTTTT
ATACATCTAAT -> TACATCTAATC
ATACCACGGGG -> TACCACGGGGG
ATACCCAGTCC -> TACCCAGTCCA
ATACCGTCTCA -> TACCGTCTCAT
ATACGTCACAT -> TACGTCACATT
ATACGTCATAA -> TACGTCATAAC
ATACTCGCGAA -> TACTCGCGAAT
ATACTGTAATT -> TACTGTAATTC
ATACTTGAGTT -> TACTTGAGTTC
ATAGACTAACA -> TAGACTAACAC
ATAGATAAAGG -> TAGATAAAGGG
ATAGCGGATCC -> TAGCGGATCCT
ATAGCTCCTCT -> TAGCTCCTCTC
ATAGCTGAGGA -> TAGCTGAGGAT
ATAGGACCTAG -> TAGGACCTAGT
ATAGTACCTTT -> TAGTACCTTTA
ATAGTATATCT -> TAGTATATCTG
ATAGTGTGATT -> TAGTGTGATTG
ATATAAAGTGG -> TATAAAGTGGT
ATATATCACTT -> TATATCACTTC
ATATCACTTCG -> TATCACTTCGC
ATATCTGTCCC -> TATCTGTCCCC
ATATTCCTATT -> TATTCCTATTT
ATCAACCGGGA -> TCAACCGGGAT
ATCAATGCAAA -> TCAATGCAAAA
ATCACGAATCT -> TCACGAATCTT
ATCACTGAACG -> TCACTGAACGA
ATCACTTCGCA -> TCACTTCGCAA
ATCAGCGCGTC -> TCAGCGCGTCT
ATCATGATCAC -> TCATGATCACG
ATCCAAAAACT -> TCCAAAAACTT
ATCCCTCCTCC -> TCCCTCCTCCG
ATCCGCAGAGG -> TCCGCAGAGGG
ATCCGCTTTAT -> TCCGCTTTATT
ATCCTACTGCG -> TCCTACTGCGG
ATCCTAGTAAT -> TCCTAGTAATA
ATCCTGGCATC -> TCCTGGCATCT
ATCGAATTTTG -> TCGAATTTTGA
ATCGACGTTCT -> TCGACGTTCTT
ATCGAGGAACT -> TCGAGGAACTA
ATCGCTACGTG -> TCGCTACGTGG
ATCGGGCGCTC -> TCGGGCGCTCT
ATCGTATTAGA -> TCGTATTAGAA
ATCGTGCAGGC -> TCGTGCAGGCG
ATCTAAACGGT -> TCTAAACGGTC
ATCTAATCAAT -> TCTAATCAATG
ATCTACGAAAT -> TCTACGAAATG
ATCTATAAAGA -> TCTATAAAGAC
ATCTATCCGCT -> TCTATCCGCTT
ATCTCAAAAAG -> TCTCAAAAAGT
ATCTCATGTTC -> TCTCATGTTCG
ATCTCCCCGGC -> TCTCCCCGGCA
ATCTCTGATCA -> TCTCTGATCAT
ATCTGTATGGT -> TCTGTATGGTG
ATCTGTCCCCG -> TCTGTCCCCGA
ATCTTATAACA -> TCTTATAACAG
ATCTTATGGAC -> TCTTATGGACA
ATGAATTTGCA -> TGAATTTGCAG
ATGAGTTTTCA -> TGAGTTTTCAT
ATGATCACGAA -> TGATCACGAAT
ATGATCGAGGA -> TGATCGAGGAA
ATGATTCCGAG -> TGATTCCGAGA
ATGCAAAAATG -> TGCAAAAATGG
ATGCATGGATA -> TGCATGGATAA
ATGCCATTGTT -> TGCCATTGTTC
ATGCCCAATAA -> TGCCCAATAAC
ATGCGTTCAAA -> TGCGTTCAAAT
ATGGACAGCGT -> TGGACAGCGTA
ATGGAGGTCAT -> TGGAGGTCATC
ATGGATAAATA -> TGGATAAATAA
ATGGATTGAAG -> TGGATTGAAGG
ATGGCGTCCCC -> TGGCGTCCCCT
ATGGCTACAGA -> TGGCTACAGAC
ATGGTACTCGT -> TGGTACTCGTA
ATGGTGAGCAC -> TGGTGAGCACA
ATGGTGTTATA -> TGGTGTTATAG
ATGTAGACATT -> TGTAGACATTG
ATGTCACTCGA -> TGTCACTCGAT
ATGTCCAGGAA -> TGTCCAGGAAA
ATGTCCTGTAG -> TGTCCTGTAGC
ATGTCGCAGAC -> TGTCGCAGACC
ATGTGCGGGAC -> TGTGCGGGACC
ATGTGCTGGAC -> TGTGCTGGACT
ATGTTCCAAGA -> TGTTCCAAGAA
ATGTTCCCCGC -> TGTTCCCCGCC
ATGTTCGGGAG -> TGTTCGGGAGA
ATGTTCTAGAC -> TGTTCTAGACG
ATGTTCTCGAG -> TGTTCTCGAGT
ATGTTGCTAGG -> TGTTGCTAGGT
ATGTTGTCCAT -> TGTTGTCCATT
ATTAGAATTAG -> TTAGAATTAGG
ATTAGGAGCCT -> TTAGGAGCCTT
ATTATAAAGCC -> TTATAAAGCCG
ATTCAATTATA -> TTCAATTATAA
ATTCATTTATG -> TTCATTTATGG
ATTCCAGTTCT -> TTCCAGTTCTT
ATTCCATCTAA -> TTCCATCTAAA
ATTCCATGAGT -> TTCCATGAGTT
ATTCCGAGATA -> TTCCGAGATAT
ATTCCTATTTT -> TTCCTATTTTA
ATTCCTTTTCA -> TTCCTTTTCAA
ATTCGATGTTG -> TTCGATGTTGT
ATTCGCGGGAC -> TTCGCGGGACC
ATTCTGTAGTC -> TTCTGTAGTCA
ATTCTGTTAGG -> TTCTGTTAGGA
ATTCTGTTTAG -> TTCTGTTTAGG
ATTGAAGGATA -> TTGAAGGATAG
ATTGATATTCC -> TTGATATTCCT
ATTGCAAGCGC -> TTGCAAGCGCT
ATTGCGCTCAG -> TTGCGCTCAGG
ATTGCTCAGAC -> TTGCTCAGACC
ATTGGCACCGG -> TTGGCACCGGA
ATTGTGCATCG -> TTGTGCATCGA
ATTGTTCCGTG -> TTGTTCCGTGT
ATTGTTCGGCA -> TTGTTCGGCAA
ATTTAACTTGA -> TTTAACTTGAG
ATTTACTGAGT -> TTTACTGAGTA
ATTTATGGTAC -> TTTATGGTACT
ATTTCCCTTTG -> TTTCCCTTTGT
ATTTGCAGTTT -> TTTGCAGTTTC
ATTTGTGCATA -> TTTGTGCATAA
ATTTTAAGGCC -> TTTTAAGGCCG
ATTTTGAGAGA -> TTTTGAGAGAC
CAAAAAAGCAG -> AAAAAAGCAGT
CAAAAACTTAC -> AAAAACTTACA
CAAAAAGTATG -> AAAAAGTATGC
CAAAAATGGTG -> AAAAATGGTGA
CAAACTAGGCT -> AAACTAGGCTC
CAAAGACCGAG -> AAAGACCGAGG
CAAAGCCCTGC -> AAAGCCCTGCA
CAAAGTGAAAA -> AAAGTGAAAAA
CAAATGCCCAA -> AAATGCCCAAT
CAACCGGGATG -> AACCGGGATGT
CAACCTTCGCG -> AACCTTCGCGT
CAACGAGTATT -> AACGAGTATTG
CAACGCGGGTT -> AACGCGGGTTA
CAACGCTTATT -> AACGCTTATTT
CAACGGCAGGG -> AACGGCAGGGA
CAACGGCCTGC -> AACGGCCTGCG
CAAGAAATGTC -> AAGAAATGTCC
CAAGATCTTAT -> AAGATCTTATA
CAAGCGCTGTT -> AAGCGCTGTTT
CAAGCTGCCTA -> AAGCTGCCTAT
CAAGTAATGTT -> AAGTAATGTTG
CAAGTGTAGAG -> AAGTGTAGAGG
CAATAACCCGC -> AATAACCCGCT
CAATAATTCCT -> AATAATTCCTT
CAATCGTGCAG -> AATCGTGCAGG
CAATGCAAAAA -> AATGCAAAAAT
CAATTATAAAG -> AATTATAAAGC
CAATTGTTCGG -> AATTGTTCGGC
CACAAGATCTT -> ACAAGATCTTA
CACACTCTATT -> ACACTCTATTC
CACAGGACTTC -> ACAGGACTTCG
CACATTTACTG -> ACATTTACTGA
CACCAGTCCTG -> ACCAGTCCTGG
CACCGAATTCG -> ACCGAATTCGA
CACCGGAATGT -> ACCGGAATGTC
CACCTGCCCAG -> ACCTGCCCAGT
CACCTTATATA -> ACCTTATATAT
CACGAATCTTA -> ACGAATCTTAT
CACGCATACGT -> ACGCATACGTC
CACGCCGCTAA -> ACGCCGCTAAC
CACGGATTGCG -> ACGGATTGCGC
CACGGGAGGAG -> ACGGGAGGAGA
CACGGGGGGGT -> ACGGGGGGGTA
CACGTGGGACT -> ACGTGGGACTT
CACTAGCCTAA -> ACTAGCCTAAA
CACTCCAAAGC -> ACTCCAAAGCC
CACTCGATCCA -> ACTCGATCCAA
CACTCTATTCT -> ACTCTATTCTG
CACTGAACGAG -> ACTGAACGAGA
CACTTCGCAAA -> ACTTCGCAAAA
CAGAAAATACG -> AGAAAATACGT
CAGAACGATCT -> AGAACGATCTA
CAGACAACCTT -> AGACAACCTTT
CAGACCACAAG -> AGACCACAAGA
CAGACCCAAGT -> AGACCCAAGTG
CAGACTGTGTT -> AGACTGTGTTC
CAGAGAGATGT -> AGAGAGATGTT
CAGAGGGCCTT -> AGAGGGCCTTG
CAGATAGATAA -> AGATAGATAAA
CAGCAGCCCCC -> AGCAGCCCCCC
CAGCCCCCCAG -> AGCCCCCCAGT
CAGCGAATACC -> AGCGAATACCA
CAGCGCGTCTC -> AGCGCGTCTCG
CAGCGGGTTCT -> AGCGGGTTCTC
CAGCGTAGGGT -> AGCGTAGGGTT
CAGCGTCAAAC -> AGCGTCAAACT
CAGCTGCCCCG -> AGCTGCCCCGC
CAGCTGGACAC -> AGCTGGACACC
CAGGAAAGCAT -> AGGAAAGCATA
CAGGAAATAGT -> AGGAAATAGTA
CAGGACGGCAA -> AGGACGGCAAT
CAGGACTTCGT -> AGGACTTCGTA
CAGGCGTCATC -> AGGCGTCATCA
CAGGGACCGGC -> AGGGACCGGCT
CAGGGCCAGGA -> AGGGCCAGGAC
CAGTACAGCTG -> AGTACAGCTGG
CAGTCCAAGTA -> AGTCCAAGTAA
CAGTCCTGGCC -> AGTCCTGGCCG
CAGTGCTTAAT -> AGTGCTTAATC
CAGTGTCGGAT -> AGTGTCGGATG
CAGTTAAGCCG -> AGTTAAGCCGT
CAGTTAGGCGC -> AGTTAGGCGCG
CAGTTCAGAGA -> AGTTCAGAGAG
CAGTTCCAGCA -> AGTTCCAGCAG
CAGTTCTTTCG -> AGTTCTTTCGG
CAGTTTCGTCA -> AGTTTCGTCAT
CATAACCTTAT -> ATAACCTTATA
CATAATAGCTG -> ATAATAGCTGA
CATACATCTAA -> ATACATCTAAT
CATACCCAGTC -> ATACCCAGTCC
CATACGTCACA -> ATACGTCACAT
CATACTGTAAT -> ATACTGTAATT
CATAGTGTGAT -> ATAGTGTGATT
CATCAGCGCGT -> ATCAGCGCGTC
CATCCCTCCTC -> ATCCCTCCTCC
CATCGACGTTC -> ATCGACGTTCT
CATCGGGCGCT -> ATCGGGCGCTC
CATCTAAACGG -> ATCTAAACGGT
CATCTAATCAA -> ATCTAATCAAT
CATCTACGAAA -> ATCTACGAAAT
CATCTCATGTT -> ATCTCATGTTC
CATGAGTTTTC -> ATGAGTTTTCA
CATGATCACGA -> ATGATCACGAA
CATGATTCCGA -> ATGATTCCGAG
CATGCCATTGT -> ATGCCATTGTT
CATGCGTTCAA -> ATGCGTTCAAA
CATGGATAAAT -> ATGGATAAATA
CATGGCGTCCC -> ATGGCGTCCCC
CATGTAGACAT -> ATGTAGACATT
CATGTGCTGGA -> ATGTGCTGGAC
CATGTTCGGGA -> ATGTTCGGGAG
CATTCCAGTTC -> ATTCCAGTTCT
CATTGCTCAGA -> ATTGCTCAGAC
CATTGTGCATC -> ATTGTGCATCG
CATTGTTCCGT -> ATTGTTCCGTG
CATTTACTGAG -> ATTTACTGAGT
CATTTATGGTA -> ATTTATGGTAC
CATTTGTGCAT -> ATTTGTGCATA
CCAAAAACTTA -> CAAAAACTTAC
CCAAAGCCCTG -> CAAAGCCCTGC
CCAAAGTGAAA -> CAAAGTGAAAA
CCAACCTTCGC -> CAACCTTCGCG
CCAAGAAATGT -> CAAGAAATGTC
CCAAGTAATGT -> CAAGTAATGTT
CCAAGTGTAGA -> CAAGTGTAGAG
CCAATAACCCG -> CAATAACCCGC
CCAATCGTGCA -> CAATCGTGCAG
CCACAAGATCT -> CACAAGATCTT
CCACGCATACG -> CACGCATACGT
CCACGGGGGGG -> CACGGGGGGGT
CCACTAGCCTA -> CACTAGCCTAA
CCAGAAAATAC -> CAGAAAATACG
CCAGCAGCCCC -> CAGCAGCCCCC
CCAGCTGCCCC -> CAGCTGCCCCG
CCAGGAAATAG -> CAGGAAATAGT
CCAGGACGGCA -> CAGGACGGCAA
CCAGTACAGCT -> CAGTACAGCTG
CCAGTCCAAGT -> CAGTCCAAGTA
CCAGTCCTGGC -> CAGTCCTGGCC
CCAGTGCTTAA -> CAGTGCTTAAT
CCAGTGTCGGA -> CAGTGTCGGAT
CCAGTTCTTTC -> CAGTTCTTTCG
CCATACCCAGT -> CATACCCAGTC
CCATAGTGTGA -> CATAGTGTGAT
CCATCTAAACG -> CATCTAAACGG
CCATGAGTTTT -> CATGAGTTTTC
CCATTGTTCCG -> CATTGTTCCGT
CCATTTGTGCA -> CATTTGTGCAT
CCCAAAGTGAA -> CCAAAGTGAAA
CCCAAGTGTAG -> CCAAGTGTAGA
CCCAATAACCC -> CCAATAACCCG
CCCAGTACAGC -> CCAGTACAGCT
CCCAGTCCAAG -> CCAGTCCAAGT
CCCAGTGTCGG -> CCAGTGTCGGA
CCCCAGTACAG -> CCCAGTACAGC
CCCCCAGTACA -> CCCCAGTACAG
CCCCCCAGTAC -> CCCCCAGTACA
CCCCCCTCTGT -> CCCCCTCTGTC
CCCCCTCTGTC -> CCCCTCTGTCC
CCCCGATCTCA -> CCCGATCTCAA
CCCCGCCATAG -> CCCGCCATAGT
CCCCGCGAGTG -> CCCGCGAGTGG
CCCCGCTCGCG -> CCCGCTCGCGA
CCCCGGCATGT -> CCCGGCATGTA
CCCCTAATTGC -> CCCTAATTGCA
CCCCTCTGTCC -> CCCTCTGTCCA
CCCGATCTCAA -> CCGATCTCAAA
CCCGCCATAGT -> CCGCCATAGTG
CCCGCGAGTGG -> CCGCGAGTGGA
CCCGCTATCGA -> CCGCTATCGAA
CCCGCTCGCGA -> CCGCTCGCGAC
CCCGGCATGTA -> CCGGCATGTAG
CCCTAATTGCA -> CCTAATTGCAA
CCCTCCTCCGT -> CCTCCTCCGTA
CCCTCTGTCCA -> CCTCTGTCCAG
CCCTGAGAATC -> CCTGAGAATCG
CCCTGCAGTTC -> CCTGCAGTTCA
CCCTTGTTTAG -> CCTTGTTTAGT
CCCTTTGTTCA -> CCTTTGTTCAG
CCGAATTCGAT -> CGAATTCGATG
CCGACGCTCAT -> CGACGCTCATG
CCGAGATATAA -> CGAGATATAAA
CCGAGGGTGCA -> CGAGGGTGCAG
CCGATACTCGC -> CGATACTCGCG
CCGATCTCAAA -> CGATCTCAAAA
CCGCAGAGGGC -> CGCAGAGGGCC
CCGCATCCCTC -> CGCATCCCTCC
CCGCCAGCTGC -> CGCCAGCTGCC
CCGCCATAGTG -> CGCCATAGTGT
CCGCGAGTGGA -> CGCGAGTGGAA
CCGCTAACCGC -> CGCTAACCGCA
CCGCTATCGAA -> CGCTATCGAAT
CCGCTCGCGAC -> CGCTCGCGACC
CCGCTTAGGCC -> CGCTTAGGCCG
CCGCTTTATTC -> CGCTTTATTCG
CCGGAATGTCA -> CGGAATGTCAC
CCGGATACCGT -> CGGATACCGTC
CCGGCATGTAG -> CGGCATGTAGA
CCGGCTGCGAT -> CGGCTGCGATC
CCGGCTGGCGC -> CGGCTGGCGCG
CCGGGATGTTC -> CGGGATGTTCT
CCGGGCGCCCC -> CGGGCGCCCCG
CCGGTGGAGCC -> CGGTGGAGCCA
CCGTACGTCAG -> CGTACGTCAGA
CCGTCAACGAG -> CGTCAACGAGT
CCGTCTCATGC -> CGTCTCATGCG
CCGTGGCTACT -> CGTGGCTACTG
CCGTGTCCATA -> CGTGTCCATAC
CCGTTGCCAAC -> CGTTGCCAACC
CCTAAAGACTC -> CTAAAGACTCT
CCTAATTGCAA -> CTAATTGCAAG
CCTACTGCGGA -> CTACTGCGGAA
CCTAGACACAC -> CTAGACACACT
CCTAGAGTTAG -> CTAGAGTTAGA
CCTAGTAATAG -> CTAGTAATAGT
CCTAGTCAACG -> CTAGTCAACGC
CCTATCACTGA -> CTATCACTGAA
CCTATTTTAAG -> CTATTTTAAGG
CCTCAGAACGA -> CTCAGAACGAT
CCTCAGTTAGG -> CTCAGTTAGGC
CCTCCGTACGT -> CTCCGTACGTC
CCTCCTCCGTA -> CTCCTCCGTAC
CCTCTCGGGGA -> CTCTCGGGGAG
CCTCTGGTGGT -> CTCTGGTGGTA
CCTCTGTCCAG -> CTCTGTCCAGA
CCTGAGAATCG -> CTGAGAATCGT
CCTGAGGTCGC -> CTGAGGTCGCT
CCTGCACCTTA -> CTGCACCTTAT
CCTGCAGTTCA -> CTGCAGTTCAG
CCTGCCCAGTG -> CTGCCCAGTGT
CCTGCGAGACC -> CTGCGAGACCG
CCTGCGCCGCT -> CTGCGCCGCTT
CCTGGCATCTA -> CTGGCATCTAC
CCTGGCCGGTG -> CTGGCCGGTGG
CCTGTAGCTTC -> CTGTAGCTTCT
CCTTAGTATTT -> CTTAGTATTTC
CCTTATAATAC -> CTTATAATACT
CCTTATATATC -> CTTATATATCA
CCTTCGCGTGC -> CTTCGCGTGCC
CCTTCTCGTGC -> CTTCTCGTGCT
CCTTGACCGTT -> CTTGACCGTTG
CCTTGGACTCG -> CTTGGACTCGA
CCTTGTTTAGT -> CTTGTTTAGTA
CCTTTATTCAA -> CTTTATTCAAT
CCTTTGTTCAG -> CTTTGTTCAGG
CCTTTTCAACG -> CTTTTCAACGC
CGAAATGTCCA -> GAAATGTCCAG
CGAATACCACG -> GAATACCACGG
CGAATCTATCC -> GAATCTATCCG
CGAATCTCCCC -> GAATCTCCCCG
CGAATCTTATG -> GAATCTTATGG
CGAATTCGATG -> GAATTCGATGT
CGAATTTTGAG -> GAATTTTGAGA
CGACCAATCGT -> GACCAATCGTG
CGACGCTCATG -> GACGCTCATGC
CGACGGGTCCT -> GACGGGTCCTC
CGACGTTCTTC -> GACGTTCTTCC
CGAGACACCGA -> GAGACACCGAA
CGAGACCGCCA -> GAGACCGCCAG
CGAGATATAAA -> GAGATATAAAG
CGAGGAACTAC -> GAGGAACTACA
CGAGGGTGCAG -> GAGGGTGCAGA
CGAGTATTGAT -> GAGTATTGATA
CGAGTGGAATC -> GAGTGGAATCC
CGAGTTAATTC -> GAGTTAATTCT
CGATACTCGCG -> GATACTCGCGA
CGATCCAAAAA -> GATCCAAAAAC
CGATCGCTACG -> GATCGCTACGT
CGATCTATAAA -> GATCTATAAAG
CGATCTCAAAA -> GATCTCAAAAA
CGATGTTCTCG -> GATGTTCTCGA
CGATGTTGTCC -> GATGTTGTCCA
CGATTCCATGA -> GATTCCATGAG
CGCAAAAAAGC -> GCAAAAAAGCA
CGCAGACCACA -> GCAGACCACAA
CGCAGAGGGCC -> GCAGAGGGCCT
CGCATACGTCA -> GCATACGTCAC
CGCATCCCTCC -> GCATCCCTCCT
CGCCAGCTGCC -> GCCAGCTGCCC
CGCCATAGTGT -> GCCATAGTGTG
CGCCCCGCGAG -> GCCCCGCGAGT
CGCCGCTAACC -> GCCGCTAACCG
CGCCGCTTAGG -> GCCGCTTAGGC
CGCCTGAGGTC -> GCCTGAGGTCG
CGCGAATCTCC -> GCGAATCTCCC
CGCGACCAATC -> GCGACCAATCG
CGCGACGGGTC -> GCGACGGGTCC
CGCGAGTGGAA -> GCGAGTGGAAT
CGCGGATTCTG -> GCGGATTCTGT
CGCGGGACCCC -> GCGGGACCCCC
CGCGGGTTATA -> GCGGGTTATAG
CGCGTCTCGTC -> GCGTCTCGTCG
CGCGTGCCTTC -> GCGTGCCTTCT
CGCTAACCGCA -> GCTAACCGCAT
CGCTACGTGGC -> GCTACGTGGCT
CGCTATCGAAT -> GCTATCGAATT
CGCTCAGCGGG -> GCTCAGCGGGT
CGCTCAGGAAA -> GCTCAGGAAAG
CGCTCATGCCA -> GCTCATGCCAT
CGCTCGCGACC -> GCTCGCGACCA
CGCTCTGGCCA -> GCTCTGGCCAC
CGCTGTTTGAT -> GCTGTTTGATG
CGCTTAGGCCG -> GCTTAGGCCGA
CGCTTATTTAA -> GCTTATTTAAC
CGCTTTATTCG -> GCTTTATTCGC
CGGAAGAGACA -> GGAAGAGACAA
CGGAATGTCAC -> GGAATGTCACT
CGGATACCGTC -> GGATACCGTCT
CGGATCCTACT -> GGATCCTACTG
CGGATGAATTT -> GGATGAATTTG
CGGATTCTGTT -> GGATTCTGTTT
CGGATTGCGCT -> GGATTGCGCTC
CGGCAACGGCA -> GGCAACGGCAG
CGGCAATTGTT -> GGCAATTGTTC
CGGCAGGGACC -> GGCAGGGACCG
CGGCATGTAGA -> GGCATGTAGAC
CGGCCTGCGAG -> GGCCTGCGAGA
CGGCTGCGATC -> GGCTGCGATCG
CGGCTGGCGCG -> GGCTGGCGCGA
CGGGACCCAAA -> GGGACCCAAAG
CGGGACCCCCC -> GGGACCCCCCT
CGGGACTACCG -> GGGACTACCGT
CGGGAGAGATC -> GGGAGAGATCT
CGGGAGGAGAT -> GGGAGGAGATG
CGGGATGTTCT -> GGGATGTTCTA
CGGGCGCCCCG -> GGGCGCCCCGC
CGGGCGCTCTG -> GGGCGCTCTGG
CGGGGAGTTCT -> GGGGAGTTCTA
CGGGGGGGTAG -> GGGGGGGTAGG
CGGGTCCTCAG -> GGGTCCTCAGT
CGGGTTATAGG -> GGGTTATAGGA
CGGGTTCTCTT -> GGGTTCTCTTG
CGGTCCCTTGT -> GGTCCCTTGTT
CGGTCCTGCGC -> GGTCCTGCGCC
CGGTGGAGCCA -> GGTGGAGCCAC
CGGTTAGCTGG -> GGTTAGCTGGA
CGGTTATGTTC -> GGTTATGTTCC
CGTACGATTCC -> GTACGATTCCA
CGTACGTCAGA -> GTACGTCAGAC
CGTAGGGTTCG -> GTAGGGTTCGG
CGTATGTGCGG -> GTATGTGCGGG
CGTATTAGAAT -> GTATTAGAATT
CGTCAAACTAG -> GTCAAACTAGG
CGTCAACGAGT -> GTCAACGAGTA
CGTCACATTTA -> GTCACATTTAC
CGTCAGACAAC -> GTCAGACAACC
CGTCATAACCT -> GTCATAACCTT
CGTCATCAGCG -> GTCATCAGCGC
CGTCATGGCGT -> GTCATGGCGTC
CGTCATTCCAG -> GTCATTCCAGT
CGTCCCCTAAT -> GTCCCCTAATT
CGTCCGGATAC -> GTCCGGATACC
CGTCGCCTGAG -> GTCGCCTGAGG
CGTCTCATGCG -> GTCTCATGCGT
CGTCTCGTCGC -> GTCTCGTCGCC
CGTGCAGGCGT -> GTGCAGGCGTC
CGTGCCTTCTC -> GTGCCTTCTCG
CGTGCTCAACG -> GTGCTCAACGG
CGTGGCTACTG -> GTGGCTACTGT
CGTGGCTTACA -> GTGGCTTACAT
CGTGGGACTTT -> GTGGGACTTTC
CGTGTCCATAC -> GTGTCCATACC
CGTTCAAATGC -> GTTCAAATGCC
CGTTCTTCCTT -> GTTCTTCCTTA
CGTTGCCAACC -> GTTGCCAACCT
CTAAACGGTCC -> TAAACGGTCCC
CTAAAGACTCT -> TAAAGACTCTC
CTAACACGGAT -> TAACACGGATT
CTAACCGCATC -> TAACCGCATCC
CTAATCAATGC -> TAATCAATGCA
CTAATTCCATC -> TAATTCCATCT
CTAATTGCAAG -> TAATTGCAAGC
CTACACGTGGG -> TACACGTGGGA
CTACAGACTGT -> TACAGACTGTG
CTACCGTGGCT -> TACCGTGGCTA
CTACGAAATGT -> TACGAAATGTC
CTACGATGTTC -> TACGATGTTCT
CTACGTGGCTT -> TACGTGGCTTA
CTACTGCGGAA -> TACTGCGGAAG
CTACTGTTCCA -> TACTGTTCCAG
CTAGACACACT -> TAGACACACTC
CTAGACGTCCG -> TAGACGTCCGG
CTAGAGTTAGA -> TAGAGTTAGAT
CTAGCCTAAAG -> TAGCCTAAAGA
CTAGGCTCTAG -> TAGGCTCTAGT
CTAGGTGTCAC -> TAGGTGTCACT
CTAGTAATAGT -> TAGTAATAGTA
CTAGTCAACGC -> TAGTCAACGCT
CTAGTTAAAAC -> TAGTTAAAACC
CTAGTTCCTGC -> TAGTTCCTGCA
CTATAAAGACT -> TATAAAGACTC
CTATCACTGAA -> TATCACTGAAC
CTATCCGCTTT -> TATCCGCTTTA
CTATCGAATTT -> TATCGAATTTT
CTATGATCGAG -> TATGATCGAGG
CTATTCTGTAG -> TATTCTGTAGT
CTATTTTAAGG -> TATTTTAAGGC
CTCAAAAAGTA -> TCAAAAAGTAT
CTCAACGGCCT -> TCAACGGCCTG
CTCAGAACGAT -> TCAGAACGATC
CTCAGACCCAA -> TCAGACCCAAG
CTCAGCGGGTT -> TCAGCGGGTTC
CTCAGCGTCAA -> TCAGCGTCAAA
CTCAGGAAAGC -> TCAGGAAAGCA
CTCAGTTAGGC -> TCAGTTAGGCG
CTCATGCCATT -> TCATGCCATTG
CTCATGCGTTC -> TCATGCGTTCA
CTCATGTGCTG -> TCATGTGCTGG
CTCATGTTCGG -> TCATGTTCGGG
CTCCAAAGCCC -> TCCAAAGCCCT
CTCCCCGGCAT -> TCCCCGGCATG
CTCCCTGAGAA -> TCCCTGAGAAT
CTCCGTACGTC -> TCCGTACGTCA
CTCCTAGACAC -> TCCTAGACACA
CTCCTCCGTAC -> TCCTCCGTACG
CTCCTCTCGGG -> TCCTCTCGGGG
CTCGAATCTAT -> TCGAATCTATC
CTCGAGTTAAT -> TCGAGTTAATT
CTCGATCCAAA -> TCGATCCAAAA
CTCGCGAATCT -> TCGCGAATCTC
CTCGCGACCAA -> TCGCGACCAAT
CTCGGGGAGTT -> TCGGGGAGTTC
CTCGTACGATT -> TCGTACGATTC
CTCGTCGCCTG -> TCGTCGCCTGA
CTCGTGCTCAA -> TCGTGCTCAAC
CTCTAGTTCCT -> TCTAGTTCCTG
CTCTATTCTGT -> TCTATTCTGTA
CTCTCAGCGTC -> TCTCAGCGTCA
CTCTCCTAGAC -> TCTCCTAGACA
CTCTCGGGGAG -> TCTCGGGGAGT
CTCTGAGCGTC -> TCTGAGCGTCA
CTCTGATCATG -> TCTGATCATGA
CTCTGGCCACG -> TCTGGCCACGC
CTCTGGTGGTA -> TCTGGTGGTAC
CTCTGTCCAGA -> TCTGTCCAGAA
CTCTTGTTGTC -> TCTTGTTGTCA
CTCTTTACATA -> TCTTTACATAC
CTGAACGAGAC -> TGAACGAGACA
CTGAGAATCGT -> TGAGAATCGTA
CTGAGCGTCAT -> TGAGCGTCATG
CTGAGGATCCT -> TGAGGATCCTA
CTGAGGTCGCT -> TGAGGTCGCTC
CTGAGTACACG -> TGAGTACACGC
CTGATCATGAT -> TGATCATGATC
CTGCACCTTAT -> TGCACCTTATA
CTGCAGTTCAG -> TGCAGTTCAGA
CTGCCCAGTGT -> TGCCCAGTGTC
CTGCCCCGCTC -> TGCCCCGCTCG
CTGCCTATCAC -> TGCCTATCACT
CTGCGAGACCG -> TGCGAGACCGC
CTGCGATCGCT -> TGCGATCGCTA
CTGCGCCGCTT -> TGCGCCGCTTA
CTGCGGAAGAG -> TGCGGAAGAGA
CTGGACACCTG -> TGGACACCTGC
CTGGACTAATT -> TGGACTAATTC
CTGGACTCATG -> TGGACTCATGT
CTGGCATCTAC -> TGGCATCTACG
CTGGCCACGCA -> TGGCCACGCAT
CTGGCCGGTGG -> TGGCCGGTGGA
CTGGCGCGACG -> TGGCGCGACGG
CTGGTGGTACT -> TGGTGGTACTC
CTGTAATTCAT -> TGTAATTCATT
CTGTAGCTTCT -> TGTAGCTTCTT
CTGTAGTCAGT -> TGTAGTCAGTT
CTGTATGGTGT -> TGTATGGTGTT
CTGTCCAGAAA -> TGTCCAGAAAA
CTGTCCCCGAT -> TGTCCCCGATC
CTGTGTTCTAC -> TGTGTTCTACG
CTGTTAGGATC -> TGTTAGGATCT
CTGTTCCAGTG -> TGTTCCAGTGC
CTGTTTAGGGT -> TGTTTAGGGTG
CTGTTTGATGG -> TGTTTGATGGC
CTTAATCCTGG -> TTAATCCTGGC
CTTACAAGCTG -> TTACAAGCTGC
CTTACATCTCA -> TTACATCTCAT
CTTAGGCCGAT -> TTAGGCCGATA
CTTAGTATTTC -> TTAGTATTTCC
CTTATAACAGC -> TTATAACAGCG
CTTATAATACT -> TTATAATACTT
CTTATATATCA -> TTATATATCAC
CTTATGGACAG -> TTATGGACAGC
CTTATTTAACT -> TTATTTAACTT
CTTCCTTAGTA -> TTCCTTAGTAT
CTTCGCAAAAA -> TTCGCAAAAAA
CTTCGCGTGCC -> TTCGCGTGCCT
CTTCGTATGTG -> TTCGTATGTGC
CTTCTCGTGCT -> TTCTCGTGCTC
CTTCTTGTACC -> TTCTTGTACCT
CTTGACCGTTG -> TTGACCGTTGC
CTTGAGTGAGC -> TTGAGTGAGCA
CTTGAGTTCAT -> TTGAGTTCATG
CTTGGACTCGA -> TTGGACTCGAA
CTTGTACCTAG -> TTGTACCTAGA
CTTGTTGTCAA -> TTGTTGTCAAT
CTTGTTTAGTA -> TTGTTTAGTAT
CTTTACATACT -> TTTACATACTG
CTTTATTCAAT -> TTTATTCAATT
CTTTATTCGCG -> TTTATTCGCGG
CTTTCGGGACT -> TTTCGGGACTA
CTTTCGGTTAG -> TTTCGGTTAGC
CTTTGTTCAGG -> TTTGTTCAGGG
CTTTTCAACGC -> TTTTCAACGCG
GAAAAAATAGC -> AAAAAATAGCT
GAAAATACGTC -> AAAATACGTCA
GAAAGCATACA -> AAAGCATACAT
GAAATAGTACC -> AAATAGTACCT
GAAATGTCCAG -> AAATGTCCAGG
GAAATGTCCTG -> AAATGTCCTGT
GAACGAGACAC -> AACGAGACACC
GAACGATCTAT -> AACGATCTATA
GAACTACACGT -> AACTACACGTG
GAAGAGACAAA -> AAGAGACAAAG
GAAGGATAGCG -> AAGGATAGCGG
GAATACCACGG -> AATACCACGGG
GAATCCGCAGA -> AATCCGCAGAG
GAATCGTATTA -> AATCGTATTAG
GAATCTATCCG -> AATCTATCCGC
GAATCTCCCCG -> AATCTCCCCGG
GAATCTTATGG -> AATCTTATGGA
GAATGTCACTC -> AATGTCACTCG
GAATTAGGAGC -> AATTAGGAGCC
GAATTCGATGT -> AATTCGATGTT
GAATTTGCAGT -> AATTTGCAGTT
GAATTTTGAGA -> AATTTTGAGAG
GACAAAGACCG -> ACAAAGACCGA
GACACACTCTA -> ACACACTCTAT
GACACCGAATT -> ACACCGAATTC
GACACCTGCCC -> ACACCTGCCCA
GACAGCGTAGG -> ACAGCGTAGGG
GACATTGTGCA -> ACATTGTGCAT
GACCAATCGTG -> ACCAATCGTGC
GACCACAAGAT -> ACCACAAGATC
GACCCAAAGTG -> ACCCAAAGTGA
GACCCAAGTGT -> ACCCAAGTGTA
GACCCCCCTCT -> ACCCCCCTCTG
GACCGAGGGTG -> ACCGAGGGTGC
GACCGCCAGCT -> ACCGCCAGCTG
GACCGGCTGGC -> ACCGGCTGGCG
GACCGTTGCCA -> ACCGTTGCCAA
GACCTAGTCAA -> ACCTAGTCAAC
GACGCTCATGC -> ACGCTCATGCC
GACGGCAATTG -> ACGGCAATTGT
GACGGGTCCTC -> ACGGGTCCTCA
GACGTCCGGAT -> ACGTCCGGATA
GACGTTCTTCC -> ACGTTCTTCCT
GACTAACACGG -> ACTAACACGGA
GACTAATTCCA -> ACTAATTCCAT
GACTACCGTGG -> ACTACCGTGGC
GACTCATGTGC -> ACTCATGTGCT
GACTCCCTGAG -> ACTCCCTGAGA
GACTCGAATCT -> ACTCGAATCTA
GACTCTCAGCG -> ACTCTCAGCGT
GACTCTCCTAG -> ACTCTCCTAGA
GACTGTGTTCT -> ACTGTGTTCTA
GACTTCGTATG -> ACTTCGTATGT
GACTTTCGGTT -> ACTTTCGGTTA
GAGAATCGTAT -> AGAATCGTATT
GAGACAAAGAC -> AGACAAAGACC
GAGACACCGAA -> AGACACCGAAT
GAGACCGCCAG -> AGACCGCCAGC
GAGACTCCCTG -> AGACTCCCTGA
GAGAGACTCCC -> AGAGACTCCCT
GAGAGATCTCT -> AGAGATCTCTG
GAGAGATGTTC -> AGAGATGTTCC
GAGATATAAAG -> AGATATAAAGT
GAGATCTCTGA -> AGATCTCTGAT
GAGATGTCGCA -> AGATGTCGCAG
GAGATGTTCCC -> AGATGTTCCCC
GAGCACAGGAC -> AGCACAGGACT
GAGCACCAGTC -> AGCACCAGTCC
GAGCCACTAGC -> AGCCACTAGCC
GAGCCTTGACC -> AGCCTTGACCG
GAGCGTCATGG -> AGCGTCATGGC
GAGGAACTACA -> AGGAACTACAC
GAGGAGATGTC -> AGGAGATGTCG
GAGGATCCTAG -> AGGATCCTAGT
GAGGGCCTTGG -> AGGGCCTTGGA
GAGGGTGCAGA -> AGGGTGCAGAT
GAGGTCATCGG -> AGGTCATCGGG
GAGGTCGCTCA -> AGGTCGCTCAG
GAGGTTCACGG -> AGGTTCACGGG
GAGTACACGCC -> AGTACACGCCG
GAGTATTGATA -> AGTATTGATAT
GAGTGAGCACC -> AGTGAGCACCA
GAGTGGAATCC -> AGTGGAATCCG
GAGTTAATTCT -> AGTTAATTCTG
GAGTTAGATGG -> AGTTAGATGGA
GAGTTCATGAT -> AGTTCATGATT
GAGTTCTATGA -> AGTTCTATGAT
GAGTTTTCATT -> AGTTTTCATTG
GATAAAGGGCC -> ATAAAGGGCCT
GATAAATAACT -> ATAAATAACTC
GATACCGTCTC -> ATACCGTCTCA
GATACTCGCGA -> ATACTCGCGAA
GATAGATAAAG -> ATAGATAAAGG
GATAGCGGATC -> ATAGCGGATCC
GATATAAAGTG -> ATATAAAGTGG
GATATTCCTAT -> ATATTCCTATT
GATCACGAATC -> ATCACGAATCT
GATCATGATCA -> ATCATGATCAC
GATCCAAAAAC -> ATCCAAAAACT
GATCCTACTGC -> ATCCTACTGCG
GATCCTAGTAA -> ATCCTAGTAAT
GATCGAGGAAC -> ATCGAGGAACT
GATCGCTACGT -> ATCGCTACGTG
GATCTATAAAG -> ATCTATAAAGA
GATCTCAAAAA -> ATCTCAAAAAG
GATCTCTGATC -> ATCTCTGATCA
GATCTGTATGG -> ATCTGTATGGT
GATCTTATAAC -> ATCTTATAACA
GATGAATTTGC -> ATGAATTTGCA
GATGGATTGAA -> ATGGATTGAAG
GATGGCTACAG -> ATGGCTACAGA
GATGTCGCAGA -> ATGTCGCAGAC
GATGTTCCCCG -> ATGTTCCCCGC
GATGTTCTAGA -> ATGTTCTAGAC
GATGTTCTCGA -> ATGTTCTCGAG
GATGTTGTCCA -> ATGTTGTCCAT
GATTCCATGAG -> ATTCCATGAGT
GATTCCGAGAT -> ATTCCGAGATA
GATTCTGTTTA -> ATTCTGTTTAG
GATTGAAGGAT -> ATTGAAGGATA
GATTGCGCTCA -> ATTGCGCTCAG
GATTGGCACCG -> ATTGGCACCGG
GCAAAAAAGCA -> CAAAAAAGCAG
GCAAAAATGGT -> CAAAAATGGTG
GCAACGGCAGG -> CAACGGCAGGG
GCAAGCGCTGT -> CAAGCGCTGTT
GCAATTGTTCG -> CAATTGTTCGG
GCACAGGACTT -> CACAGGACTTC
GCACCAGTCCT -> CACCAGTCCTG
GCACCGGAATG -> CACCGGAATGT
GCACCTTATAT -> CACCTTATATA
GCAGACCACAA -> CAGACCACAAG
GCAGAGGGCCT -> CAGAGGGCCTT
GCAGATAGATA -> CAGATAGATAA
GCAGCCCCCCA -> CAGCCCCCCAG
GCAGGCGTCAT -> CAGGCGTCATC
GCAGGGACCGG -> CAGGGACCGGC
GCAGTTAAGCC -> CAGTTAAGCCG
GCAGTTCAGAG -> CAGTTCAGAGA
GCAGTTTCGTC -> CAGTTTCGTCA
GCATAATAGCT -> CATAATAGCTG
GCATACATCTA -> CATACATCTAA
GCATACGTCAC -> CATACGTCACA
GCATCCCTCCT -> CATCCCTCCTC
GCATCGACGTT -> CATCGACGTTC
GCATCTACGAA -> CATCTACGAAA
GCATGGATAAA -> CATGGATAAAT
GCATGTAGACA -> CATGTAGACAT
GCCAACCTTCG -> CCAACCTTCGC
GCCACGCATAC -> CCACGCATACG
GCCACTAGCCT -> CCACTAGCCTA
GCCAGCTGCCC -> CCAGCTGCCCC
GCCAGGACGGC -> CCAGGACGGCA
GCCATAGTGTG -> CCATAGTGTGA
GCCATTGTTCC -> CCATTGTTCCG
GCCCAATAACC -> CCCAATAACCC
GCCCAGTGTCG -> CCCAGTGTCGG
GCCCCCCAGTA -> CCCCCCAGTAC
GCCCCGCGAGT -> CCCCGCGAGTG
GCCCCGCTCGC -> CCCCGCTCGCG
GCCCTGCAGTT -> CCCTGCAGTTC
GCCGACGCTCA -> CCGACGCTCAT
GCCGATACTCG -> CCGATACTCGC
GCCGCTAACCG -> CCGCTAACCGC
GCCGCTTAGGC -> CCGCTTAGGCC
GCCGGCTGCGA -> CCGGCTGCGAT
GCCGGTGGAGC -> CCGGTGGAGCC
GCCGTCAACGA -> CCGTCAACGAG
GCCTAAAGACT -> CCTAAAGACTC
GCCTATCACTG -> CCTATCACTGA
GCCTCAGAACG -> CCTCAGAACGA
GCCTGAGGTCG -> CCTGAGGTCGC
GCCTGCGAGAC -> CCTGCGAGACC
GCCTTCTCGTG -> CCTTCTCGTGC
GCCTTGACCGT -> CCTTGACCGTT
GCCTTGGACTC -> CCTTGGACTCG
GCGAATACCAC -> CGAATACCACG
GCGAATCTCCC -> CGAATCTCCCC
GCGACCAATCG -> CGACCAATCGT
GCGACGGGTCC -> CGACGGGTCCT
GCGAGACCGCC -> CGAGACCGCCA
GCGAGTGGAAT -> CGAGTGGAATC
GCGATCGCTAC -> CGATCGCTACG
GCGCCCCGCGA -> CGCCCCGCGAG
GCGCCGCTTAG -> CGCCGCTTAGG
GCGCGACGGGT -> CGCGACGGGTC
GCGCGGATTCT -> CGCGGATTCTG
GCGCGTCTCGT -> CGCGTCTCGTC
GCGCTCAGGAA -> CGCTCAGGAAA
GCGCTCTGGCC -> CGCTCTGGCCA
GCGCTGTTTGA -> CGCTGTTTGAT
GCGGAAGAGAC -> CGGAAGAGACA
GCGGATCCTAC -> CGGATCCTACT
GCGGATTCTGT -> CGGATTCTGTT
GCGGGACCCAA -> CGGGACCCAAA
GCGGGACCCCC -> CGGGACCCCCC
GCGGGTTATAG -> CGGGTTATAGG
GCGGGTTCTCT -> CGGGTTCTCTT
GCGTAGGGTTC -> CGTAGGGTTCG
GCGTCAAACTA -> CGTCAAACTAG
GCGTCATCAGC -> CGTCATCAGCG
GCGTCATGGCG -> CGTCATGGCGT
GCGTCCCCTAA -> CGTCCCCTAAT
GCGTCTCGTCG -> CGTCTCGTCGC
GCGTGCCTTCT -> CGTGCCTTCTC
GCGTTCAAATG -> CGTTCAAATGC
GCTAACCGCAT -> CTAACCGCATC
GCTACAGACTG -> CTACAGACTGT
GCTACGTGGCT -> CTACGTGGCTT
GCTACTGTTCC -> CTACTGTTCCA
GCTAGGTGTCA -> CTAGGTGTCAC
GCTAGTTAAAA -> CTAGTTAAAAC
GCTATCGAATT -> CTATCGAATTT
GCTCAACGGCC -> CTCAACGGCCT
GCTCAGACCCA -> CTCAGACCCAA
GCTCAGCGGGT -> CTCAGCGGGTT
GCTCAGGAAAG -> CTCAGGAAAGC
GCTCATGCCAT -> CTCATGCCATT
GCTCCTCTCGG -> CTCCTCTCGGG
GCTCGCGACCA -> CTCGCGACCAA
GCTCTAGTTCC -> CTCTAGTTCCT
GCTCTGGCCAC -> CTCTGGCCACG
GCTGAGGATCC -> CTGAGGATCCT
GCTGCCCCGCT -> CTGCCCCGCTC
GCTGCCTATCA -> CTGCCTATCAC
GCTGCGATCGC -> CTGCGATCGCT
GCTGGACACCT -> CTGGACACCTG
GCTGGACTAAT -> CTGGACTAATT
GCTGGACTCAT -> CTGGACTCATG
GCTGGCGCGAC -> CTGGCGCGACG
GCTGTTTGATG -> CTGTTTGATGG
GCTTAATCCTG -> CTTAATCCTGG
GCTTACATCTC -> CTTACATCTCA
GCTTAGGCCGA -> CTTAGGCCGAT
GCTTATTTAAC -> CTTATTTAACT
GCTTCTTGTAC -> CTTCTTGTACC
GCTTTATTCGC -> CTTTATTCGCG
GGAAAGCATAC -> GAAAGCATACA
GGAAATAGTAC -> GAAATAGTACC
GGAACTACACG -> GAACTACACGT
GGAAGAGACAA -> GAAGAGACAAA
GGAATCCGCAG -> GAATCCGCAGA
GGAATGTCACT -> GAATGTCACTC
GGACACCTGCC -> GACACCTGCCC
GGACAGCGTAG -> GACAGCGTAGG
GGACCCAAAGT -> GACCCAAAGTG
GGACCCCCCTC -> GACCCCCCTCT
GGACCGGCTGG -> GACCGGCTGGC
GGACCTAGTCA -> GACCTAGTCAA
GGACGGCAATT -> GACGGCAATTG
GGACTAATTCC -> GACTAATTCCA
GGACTACCGTG -> GACTACCGTGG
GGACTCATGTG -> GACTCATGTGC
GGACTCGAATC -> GACTCGAATCT
GGACTTCGTAT -> GACTTCGTATG
GGACTTTCGGT -> GACTTTCGGTT
GGAGAGATCTC -> GAGAGATCTCT
GGAGATGTCGC -> GAGATGTCGCA
GGAGCCACTAG -> GAGCCACTAGC
GGAGCCTTGAC -> GAGCCTTGACC
GGAGGAGATGT -> GAGGAGATGTC
GGAGGTCATCG -> GAGGTCATCGG
GGAGTTCTATG -> GAGTTCTATGA
GGATAAATAAC -> GATAAATAACT
GGATACCGTCT -> GATACCGTCTC
GGATAGCGGAT -> GATAGCGGATC
GGATCCTACTG -> GATCCTACTGC
GGATCCTAGTA -> GATCCTAGTAA
GGATCTGTATG -> GATCTGTATGG
GGATGAATTTG -> GATGAATTTGC
GGATGTTCTAG -> GATGTTCTAGA
GGATTCTGTTT -> GATTCTGTTTA
GGATTGAAGGA -> GATTGAAGGAT
GGATTGCGCTC -> GATTGCGCTCA
GGCAACGGCAG -> GCAACGGCAGG
GGCAATTGTTC -> GCAATTGTTCG
GGCACCGGAAT -> GCACCGGAATG
GGCAGGGACCG -> GCAGGGACCGG
GGCATCTACGA -> GCATCTACGAA
GGCATGTAGAC -> GCATGTAGACA
GGCCACGCATA -> GCCACGCATAC
GGCCAGGACGG -> GCCAGGACGGC
GGCCGATACTC -> GCCGATACTCG
GGCCGGCTGCG -> GCCGGCTGCGA
GGCCGGTGGAG -> GCCGGTGGAGC
GGCCTCAGAAC -> GCCTCAGAACG
GGCCTGCGAGA -> GCCTGCGAGAC
GGCCTTGGACT -> GCCTTGGACTC
GGCGCCCCGCG -> GCGCCCCGCGA
GGCGCGACGGG -> GCGCGACGGGT
GGCGCGGATTC -> GCGCGGATTCT
GGCGCTCTGGC -> GCGCTCTGGCC
GGCGTCATCAG -> GCGTCATCAGC
GGCGTCCCCTA -> GCGTCCCCTAA
GGCTACAGACT -> GCTACAGACTG
GGCTACTGTTC -> GCTACTGTTCC
GGCTCTAGTTC -> GCTCTAGTTCC
GGCTGCGATCG -> GCTGCGATCGC
GGCTGGCGCGA -> GCTGGCGCGAC
GGCTTACATCT -> GCTTACATCTC
GGGACCCAAAG -> GGACCCAAAGT
GGGACCCCCCT -> GGACCCCCCTC
GGGACCGGCTG -> GGACCGGCTGG
GGGACTACCGT -> GGACTACCGTG
GGGACTTTCGG -> GGACTTTCGGT
GGGAGAGATCT -> GGAGAGATCTC
GGGAGGAGATG -> GGAGGAGATGT
GGGAGTTCTAT -> GGAGTTCTATG
GGGATGTTCTA -> GGATGTTCTAG
GGGCCAGGACG -> GGCCAGGACGG
GGGCCTCAGAA -> GGCCTCAGAAC
GGGCCTTGGAC -> GGCCTTGGACT
GGGCGCCCCGC -> GGCGCCCCGCG
GGGCGCTCTGG -> GGCGCTCTGGC
GGGGAGTTCTA -> GGGAGTTCTAT
GGGGGGGTAGG -> GGGGGGTAGGT
GGGGGGTAGGT -> GGGGGTAGGTG
GGGGGTAGGTG -> GGGGTAGGTGT
GGGGTAGGTGT -> GGGTAGGTGTA
GGGTAGGTGTA -> GGTAGGTGTAA
GGGTCCTCAGT -> GGTCCTCAGTT
GGGTGCAGATA -> GGTGCAGATAG
GGGTGCTAGTT -> GGTGCTAGTTA
GGGTTATAGGA -> GGTTATAGGAC
GGGTTCGGTCC -> GGTTCGGTCCT
GGGTTCTCTTG -> GGTTCTCTTGT
GGTACTCGTAC -> GTACTCGTACG
GGTACTCTTTA -> GTACTCTTTAC
GGTAGGTGTAA -> GTAGGTGTAAC
GGTATCAACCG -> GTATCAACCGG
GGTCATCGGGC -> GTCATCGGGCG
GGTCCCTTGTT -> GTCCCTTGTTT
GGTCCTCAGTT -> GTCCTCAGTTA
GGTCCTGCGCC -> GTCCTGCGCCG
GGTCGCTCAGC -> GTCGCTCAGCG
GGTGAGCACAG -> GTGAGCACAGG
GGTGCAGATAG -> GTGCAGATAGA
GGTGCTAGTTA -> GTGCTAGTTAA
GGTGGAGCCAC -> GTGGAGCCACT
GGTGGTACTCT -> GTGGTACTCTT
GGTGTAACGGT -> GTGTAACGGTT
GGTGTCACTCC -> GTGTCACTCCA
GGTGTTATAGA -> GTGTTATAGAC
GGTTAGCTGGA -> GTTAGCTGGAC
GGTTATAGGAC -> GTTATAGGACC
GGTTATGTTCC -> GTTATGTTCCA
GGTTCACGGGA -> GTTCACGGGAG
GGTTCGGTCCT -> GTTCGGTCCTG
GGTTCTCTTGT -> GTTCTCTTGTT
GTAACGGTTAT -> TAACGGTTATG
GTAATAGTATA -> TAATAGTATAT
GTAATGTTGCT -> TAATGTTGCTA
GTAATTCATTT -> TAATTCATTTA
GTACACGCCGC -> TACACGCCGCT
GTACAGCTGGA -> TACAGCTGGAC
GTACCTAGAGT -> TACCTAGAGTT
GTACCTTTATT -> TACCTTTATTC
GTACGATTCCA -> TACGATTCCAT
GTACGTCAGAC -> TACGTCAGACA
GTACTCGTACG -> TACTCGTACGA
GTACTCTTTAC -> TACTCTTTACA
GTAGACATTGT -> TAGACATTGTG
GTAGAGGTTCA -> TAGAGGTTCAC
GTAGCTTCTTG -> TAGCTTCTTGT
GTAGGGTTCGG -> TAGGGTTCGGT
GTAGGTGTAAC -> TAGGTGTAACG
GTAGTCAGTTC -> TAGTCAGTTCC
GTATATCTGTC -> TATATCTGTCC
GTATCAACCGG -> TATCAACCGGG
GTATGCATGGA -> TATGCATGGAT
GTATGGAGGTC -> TATGGAGGTCA
GTATGGTGTTA -> TATGGTGTTAT
GTATGTGCGGG -> TATGTGCGGGA
GTATTAGAATT -> TATTAGAATTA
GTATTGATATT -> TATTGATATTC
GTATTTCCCTT -> TATTTCCCTTT
GTCAAACTAGG -> TCAAACTAGGC
GTCAACGAGTA -> TCAACGAGTAT
GTCAACGCTTA -> TCAACGCTTAT
GTCAATAATTC -> TCAATAATTCC
GTCACATTTAC -> TCACATTTACT
GTCACTCCAAA -> TCACTCCAAAG
GTCACTCGATC -> TCACTCGATCC
GTCAGACAACC -> TCAGACAACCT
GTCAGTTCCAG -> TCAGTTCCAGC
GTCATAACCTT -> TCATAACCTTA
GTCATCAGCGC -> TCATCAGCGCG
GTCATCGGGCG -> TCATCGGGCGC
GTCATGGCGTC -> TCATGGCGTCC
GTCATTCCAGT -> TCATTCCAGTT
GTCCAAGTAAT -> TCCAAGTAATG
GTCCAGAAAAT -> TCCAGAAAATA
GTCCAGGAAAT -> TCCAGGAAATA
GTCCATACCCA -> TCCATACCCAG
GTCCATTTGTG -> TCCATTTGTGC
GTCCCCGATCT -> TCCCCGATCTC
GTCCCCTAATT -> TCCCCTAATTG
GTCCCTTGTTT -> TCCCTTGTTTA
GTCCGGATACC -> TCCGGATACCG
GTCCTCAGTTA -> TCCTCAGTTAG
GTCCTGCGCCG -> TCCTGCGCCGC
GTCCTGGCCGG -> TCCTGGCCGGT
GTCCTGTAGCT -> TCCTGTAGCTT
GTCGCAGACCA -> TCGCAGACCAC
GTCGCCTGAGG -> TCGCCTGAGGT
GTCGCTCAGCG -> TCGCTCAGCGG
GTCGGATGAAT -> TCGGATGAATT
GTCTCATGCGT -> TCTCATGCGTT
GTCTCGTCGCC -> TCTCGTCGCCT
GTGAAAAAATA -> TGAAAAAATAG
GTGAGCACAGG -> TGAGCACAGGA
GTGAGCACCAG -> TGAGCACCAGT
GTGATTGGCAC -> TGATTGGCACC
GTGCAGATAGA -> TGCAGATAGAT
GTGCAGGCGTC -> TGCAGGCGTCA
GTGCATAATAG -> TGCATAATAGC
GTGCATCGACG -> TGCATCGACGT
GTGCCTTCTCG -> TGCCTTCTCGT
GTGCGGGACCC -> TGCGGGACCCA
GTGCTAGTTAA -> TGCTAGTTAAA
GTGCTCAACGG -> TGCTCAACGGC
GTGCTGGACTA -> TGCTGGACTAA
GTGCTTAATCC -> TGCTTAATCCT
GTGGAATCCGC -> TGGAATCCGCA
GTGGAGCCACT -> TGGAGCCACTA
GTGGCTACTGT -> TGGCTACTGTT
GTGGCTTACAT -> TGGCTTACATC
GTGGGACTTTC -> TGGGACTTTCG
GTGGTACTCTT -> TGGTACTCTTT
GTGGTATCAAC -> TGGTATCAACC
GTGTAACGGTT -> TGTAACGGTTA
GTGTAGAGGTT -> TGTAGAGGTTC
GTGTCACTCCA -> TGTCACTCCAA
GTGTCCATACC -> TGTCCATACCC
GTGTCGGATGA -> TGTCGGATGAA
GTGTGATTGGC -> TGTGATTGGCA
GTGTTATAGAC -> TGTTATAGACT
GTGTTCTACGA -> TGTTCTACGAT
GTTAAAACCGG -> TTAAAACCGGG
GTTAAGCCGTC -> TTAAGCCGTCA
GTTAATTCTGT -> TTAATTCTGTT
GTTAGATGGAT -> TTAGATGGATT
GTTAGCTGGAC -> TTAGCTGGACT
GTTAGGATCTG -> TTAGGATCTGT
GTTAGGCGCGG -> TTAGGCGCGGA
GTTATAGACTA -> TTATAGACTAA
GTTATAGGACC -> TTATAGGACCT
GTTATGTTCCA -> TTATGTTCCAA
GTTCAAATGCC -> TTCAAATGCCC
GTTCACGGGAG -> TTCACGGGAGG
GTTCAGAGAGA -> TTCAGAGAGAT
GTTCAGGGCCA -> TTCAGGGCCAG
GTTCATGATTC -> TTCATGATTCC
GTTCCAAGAAA -> TTCCAAGAAAT
GTTCCAGCAGC -> TTCCAGCAGCC
GTTCCAGTGCT -> TTCCAGTGCTT
GTTCCCCGCCA -> TTCCCCGCCAT
GTTCCGTGTCC -> TTCCGTGTCCA
GTTCCTGCACC -> TTCCTGCACCT
GTTCGGCAACG -> TTCGGCAACGG
GTTCGGGAGAG -> TTCGGGAGAGA
GTTCGGTCCTG -> TTCGGTCCTGC
GTTCTACGATG -> TTCTACGATGT
GTTCTAGACGT -> TTCTAGACGTC
GTTCTATGATC -> TTCTATGATCG
GTTCTCGAGTT -> TTCTCGAGTTA
GTTCTCTTGTT -> TTCTCTTGTTG
GTTCTTCCTTA -> TTCTTCCTTAG
GTTCTTTCGGG -> TTCTTTCGGGA
GTTGCCAACCT -> TTGCCAACCTT
GTTGCTAGGTG -> TTGCTAGGTGT
GTTGTCAATAA -> TTGTCAATAAT
GTTGTCCATTT -> TTGTCCATTTG
GTTTAGGGTGC -> TTTAGGGTGCT
GTTTAGTATGG -> TTTAGTATGGA
GTTTCGTCATT -> TTTCGTCATTC
GTTTGATGGCT -> TTTGATGGCTA
GTTTTCATTGC -> TTTTCATTGCT
TAAAACCGGGC -> AAAACCGGGCG
TAAACGGTCCC -> AAACGGTCCCT
TAAAGACTCTC -> AAAGACTCTCA,AAAGACTCTCC
TAAAGCCGACG -> AAAGCCGACGC
TAAAGGGCCTC -> AAAGGGCCTCA
TAAAGTGGTAT -> AAAGTGGTATC
TAAATAACTCT -> AAATAACTCTG
TAACACGGATT -> AACACGGATTG
TAACAGCGAAT -> AACAGCGAATA
TAACCCGCTAT -> AACCCGCTATC
TAACCGCATCC -> AACCGCATCCC
TAACCTTATAA -> AACCTTATAAT
TAACGGTTATG -> AACGGTTATGT
TAACTCTGAGC -> AACTCTGAGCG
TAACTTGAGTG -> AACTTGAGTGA
TAAGCCGTCAA -> AAGCCGTCAAC
TAAGGCCGGCT -> AAGGCCGGCTG
TAATACTTGAG -> AATACTTGAGT
TAATAGCTGAG -> AATAGCTGAGG
TAATAGTATAT -> AATAGTATATC
TAATCAATGCA -> AATCAATGCAA
TAATCCTGGCA -> AATCCTGGCAT
TAATGTTGCTA -> AATGTTGCTAG
TAATTCATTTA -> AATTCATTTAT
TAATTCCATCT -> AATTCCATCTA
TAATTCCTTTT -> AATTCCTTTTC
TAATTCTGTTA -> AATTCTGTTAG
TAATTGCAAGC -> AATTGCAAGCG
TACAAGCTGCC -> ACAAGCTGCCT
TACACGCCGCT -> ACACGCCGCTA
TACACGTGGGA -> ACACGTGGGAC
TACAGACTGTG -> ACAGACTGTGT
TACAGCTGGAC -> ACAGCTGGACA
TACATACTGTA -> ACATACTGTAA
TACATCTAATC -> ACATCTAATCA
TACATCTCATG -> ACATCTCATGT
TACCACGGGGG -> ACCACGGGGGG
TACCCAGTCCA -> ACCCAGTCCAA
TACCGTCTCAT -> ACCGTCTCATG
TACCGTGGCTA -> ACCGTGGCTAC
TACCTAGAGTT -> ACCTAGAGTTA
TACCTTTATTC -> ACCTTTATTCA
TACGAAATGTC -> ACGAAATGTCC
TACGATGTTCT -> ACGATGTTCTC
TACGATTCCAT -> ACGATTCCATG
TACGTCACATT -> ACGTCACATTT
TACGTCAGACA -> ACGTCAGACAA
TACGTCATAAC -> ACGTCATAACC
TACGTGGCTTA -> ACGTGGCTTAC
TACTCGCGAAT -> ACTCGCGAATC
TACTCGTACGA -> ACTCGTACGAT
TACTCTTTACA -> ACTCTTTACAT
TACTGAGTACA -> ACTGAGTACAC
TACTGCGGAAG -> ACTGCGGAAGA
TACTGTAATTC -> ACTGTAATTCA
TACTGTTCCAG -> ACTGTTCCAGT
TACTTGAGTTC -> ACTTGAGTTCA
TAGAATTAGGA -> AGAATTAGGAG
TAGACACACTC -> AGACACACTCT
TAGACATTGTG -> AGACATTGTGC
TAGACGTCCGG -> AGACGTCCGGA
TAGACTAACAC -> AGACTAACACG
TAGAGGTTCAC -> AGAGGTTCACG
TAGAGTTAGAT -> AGAGTTAGATG
TAGATAAAGGG -> AGATAAAGGGC
TAGATGGATTG -> AGATGGATTGA
TAGCCTAAAGA -> AGCCTAAAGAC
TAGCGGATCCT -> AGCGGATCCTA
TAGCTCCTCTC -> AGCTCCTCTCG
TAGCTGAGGAT -> AGCTGAGGATC
TAGCTGGACTC -> AGCTGGACTCA
TAGCTTCTTGT -> AGCTTCTTGTA
TAGGACCTAGT -> AGGACCTAGTC
TAGGAGCCTTG -> AGGAGCCTTGA
TAGGATCTGTA -> AGGATCTGTAT
TAGGCCGATAC -> AGGCCGATACT
TAGGCGCGGAT -> AGGCGCGGATT
TAGGCTCTAGT -> AGGCTCTAGTT
TAGGGTGCTAG -> AGGGTGCTAGT
TAGGGTTCGGT -> AGGGTTCGGTC
TAGGTGTAACG -> AGGTGTAACGG
TAGGTGTCACT -> AGGTGTCACTC
TAGTAATAGTA -> AGTAATAGTAT
TAGTACCTTTA -> AGTACCTTTAT
TAGTATATCTG -> AGTATATCTGT
TAGTATGGAGG -> AGTATGGAGGT
TAGTATTTCCC -> AGTATTTCCCT
TAGTCAACGCT -> AGTCAACGCTT
TAGTCAGTTCC -> AGTCAGTTCCA
TAGTGTGATTG -> AGTGTGATTGG
TAGTTAAAACC -> AGTTAAAACCG
TAGTTCCTGCA -> AGTTCCTGCAC
TATAAAGACTC -> ATAAAGACTCT
TATAAAGCCGA -> ATAAAGCCGAC
TATAAAGTGGT -> ATAAAGTGGTA
TATAACAGCGA -> ATAACAGCGAA
TATAATACTTG -> ATAATACTTGA
TATAGACTAAC -> ATAGACTAACA
TATAGGACCTA -> ATAGGACCTAG
TATATATCACT -> ATATATCACTT
TATATCACTTC -> ATATCACTTCG
TATATCTGTCC -> ATATCTGTCCC
TATCAACCGGG -> ATCAACCGGGA
TATCACTGAAC -> ATCACTGAACG
TATCACTTCGC -> ATCACTTCGCA
TATCCGCTTTA -> ATCCGCTTTAT
TATCGAATTTT -> ATCGAATTTTG
TATCTGTCCCC -> ATCTGTCCCCG
TATGATCGAGG -> ATGATCGAGGA
TATGCATGGAT -> ATGCATGGATA
TATGGACAGCG -> ATGGACAGCGT
TATGGAGGTCA -> ATGGAGGTCAT
TATGGTACTCG -> ATGGTACTCGT
TATGGTGTTAT -> ATGGTGTTATA
TATGTGCGGGA -> ATGTGCGGGAC
TATGTTCCAAG -> ATGTTCCAAGA
TATTAGAATTA -> ATTAGAATTAG
TATTCAATTAT -> ATTCAATTATA
TATTCCTATTT -> ATTCCTATTTT
TATTCGCGGGA -> ATTCGCGGGAC
TATTCTGTAGT -> ATTCTGTAGTC
TATTGATATTC -> ATTGATATTCC
TATTTAACTTG -> ATTTAACTTGA
TATTTCCCTTT -> ATTTCCCTTTG
TATTTTAAGGC -> ATTTTAAGGCC
TCAAAAAGTAT -> CAAAAAGTATG
TCAAACTAGGC -> CAAACTAGGCT
TCAAATGCCCA -> CAAATGCCCAA
TCAACCGGGAT -> CAACCGGGATG
TCAACGAGTAT -> CAACGAGTATT
TCAACGCGGGT -> CAACGCGGGTT
TCAACGCTTAT -> CAACGCTTATT
TCAACGGCCTG -> CAACGGCCTGC
TCAATAATTCC -> CAATAATTCCT
TCAATGCAAAA -> CAATGCAAAAA
TCAATTATAAA -> CAATTATAAAG
TCACATTTACT -> CACATTTACTG
TCACGAATCTT -> CACGAATCTTA
TCACGGGAGGA -> CACGGGAGGAG
TCACTCCAAAG -> CACTCCAAAGC
TCACTCGATCC -> CACTCGATCCA
TCACTGAACGA -> CACTGAACGAG
TCACTTCGCAA -> CACTTCGCAAA
TCAGAACGATC -> CAGAACGATCT
TCAGACAACCT -> CAGACAACCTT
TCAGACCCAAG -> CAGACCCAAGT
TCAGAGAGATG -> CAGAGAGATGT
TCAGCGCGTCT -> CAGCGCGTCTC
TCAGCGGGTTC -> CAGCGGGTTCT
TCAGCGTCAAA -> CAGCGTCAAAC
TCAGGAAAGCA -> CAGGAAAGCAT
TCAGGGCCAGG -> CAGGGCCAGGA
TCAGTTAGGCG -> CAGTTAGGCGC
TCAGTTCCAGC -> CAGTTCCAGCA
TCATAACCTTA -> CATAACCTTAT
TCATCAGCGCG -> CATCAGCGCGT
TCATCGGGCGC -> CATCGGGCGCT
TCATGATCACG -> CATGATCACGA
TCATGATTCCG -> CATGATTCCGA
TCATGCCATTG -> CATGCCATTGT
TCATGCGTTCA -> CATGCGTTCAA
TCATGGCGTCC -> CATGGCGTCCC
TCATGTGCTGG -> CATGTGCTGGA
TCATGTTCGGG -> CATGTTCGGGA
TCATTCCAGTT -> CATTCCAGTTC
TCATTGCTCAG -> CATTGCTCAGA
TCATTTATGGT -> CATTTATGGTA
TCCAAAAACTT -> CCAAAAACTTA
TCCAAAGCCCT -> CCAAAGCCCTG
TCCAAGAAATG -> CCAAGAAATGT
TCCAAGTAATG -> CCAAGTAATGT
TCCAGAAAATA -> CCAGAAAATAC
TCCAGCAGCCC -> CCAGCAGCCCC
TCCAGGAAATA -> CCAGGAAATAG
TCCAGTGCTTA -> CCAGTGCTTAA
TCCAGTTCTTT -> CCAGTTCTTTC
TCCATACCCAG -> CCATACCCAGT
TCCATCTAAAC -> CCATCTAAACG
TCCATGAGTTT -> CCATGAGTTTT
TCCATTTGTGC -> CCATTTGTGCA
TCCCCGATCTC -> CCCCGATCTCA
TCCCCGCCATA -> CCCCGCCATAG
TCCCCGGCATG -> CCCCGGCATGT
TCCCCTAATTG -> CCCCTAATTGC
TCCCTCCTCCG -> CCCTCCTCCGT
TCCCTGAGAAT -> CCCTGAGAATC
TCCCTTGTTTA -> CCCTTGTTTAG
TCCCTTTGTTC -> CCCTTTGTTCA
TCCGAGATATA -> CCGAGATATAA
TCCGCAGAGGG -> CCGCAGAGGGC
TCCGCTTTATT -> CCGCTTTATTC
TCCGGATACCG -> CCGGATACCGT
TCCGTACGTCA -> CCGTACGTCAG
TCCGTGTCCAT -> CCGTGTCCATA
TCCTACTGCGG -> CCTACTGCGGA
TCCTAGACACA -> CCTAGACACAC
TCCTAGTAATA -> CCTAGTAATAG
TCCTATTTTAA -> CCTATTTTAAG
TCCTCAGTTAG -> CCTCAGTTAGG
TCCTCCGTACG -> CCTCCGTACGT
TCCTCTCGGGG -> CCTCTCGGGGA
TCCTGCACCTT -> CCTGCACCTTA
TCCTGCGCCGC -> CCTGCGCCGCT
TCCTGGCATCT -> CCTGGCATCTA
TCCTGGCCGGT -> CCTGGCCGGTG
TCCTGTAGCTT -> CCTGTAGCTTC
TCCTTAGTATT -> CCTTAGTATTT
TCCTTTTCAAC -> CCTTTTCAACG
TCGAATCTATC -> CGAATCTATCC
TCGAATTTTGA -> CGAATTTTGAG
TCGACGTTCTT -> CGACGTTCTTC
TCGAGGAACTA -> CGAGGAACTAC
TCGAGTTAATT -> CGAGTTAATTC
TCGATCCAAAA -> CGATCCAAAAA
TCGATGTTGTC -> CGATGTTGTCC
TCGCAAAAAAG -> CGCAAAAAAGC
TCGCAGACCAC -> CGCAGACCACA
TCGCCTGAGGT -> CGCCTGAGGTC
TCGCGAATCTC -> CGCGAATCTCC
TCGCGACCAAT -> CGCGACCAATC
TCGCGGGACCC -> CGCGGGACCCC
TCGCGTGCCTT -> CGCGTGCCTTC
TCGCTACGTGG -> CGCTACGTGGC
TCGCTCAGCGG -> CGCTCAGCGGG
TCGGATGAATT -> CGGATGAATTT
TCGGCAACGGC -> CGGCAACGGCA
TCGGGACTACC -> CGGGACTACCG
TCGGGAGAGAT -> CGGGAGAGATC
TCGGGCGCTCT -> CGGGCGCTCTG
TCGGGGAGTTC -> CGGGGAGTTCT
TCGGTCCTGCG -> CGGTCCTGCGC
TCGGTTAGCTG -> CGGTTAGCTGG
TCGTACGATTC -> CGTACGATTCC
TCGTATGTGCG -> CGTATGTGCGG
TCGTATTAGAA -> CGTATTAGAAT
TCGTCATTCCA -> CGTCATTCCAG
TCGTCGCCTGA -> CGTCGCCTGAG
TCGTGCAGGCG -> CGTGCAGGCGT
TCGTGCTCAAC -> CGTGCTCAACG
TCTAAACGGTC -> CTAAACGGTCC
TCTAATCAATG -> CTAATCAATGC
TCTACGAAATG -> CTACGAAATGT
TCTACGATGTT -> CTACGATGTTC
TCTAGACGTCC -> CTAGACGTCCG
TCTAGTTCCTG -> CTAGTTCCTGC
TCTATAAAGAC -> CTATAAAGACT
TCTATCCGCTT -> CTATCCGCTTT
TCTATGATCGA -> CTATGATCGAG
TCTATTCTGTA -> CTATTCTGTAG
TCTCAAAAAGT -> CTCAAAAAGTA
TCTCAGCGTCA -> CTCAGCGTCAA
TCTCATGCGTT -> CTCATGCGTTC
TCTCATGTTCG -> CTCATGTTCGG
TCTCCCCGGCA -> CTCCCCGGCAT
TCTCCTAGACA -> CTCCTAGACAC
TCTCGAGTTAA -> CTCGAGTTAAT
TCTCGGGGAGT -> CTCGGGGAGTT
TCTCGTCGCCT -> CTCGTCGCCTG
TCTCGTGCTCA -> CTCGTGCTCAA
TCTCTGATCAT -> CTCTGATCATG
TCTCTTGTTGT -> CTCTTGTTGTC
TCTGAGCGTCA -> CTGAGCGTCAT
TCTGATCATGA -> CTGATCATGAT
TCTGGCCACGC -> CTGGCCACGCA
TCTGGTGGTAC -> CTGGTGGTACT
TCTGTAGTCAG -> CTGTAGTCAGT
TCTGTATGGTG -> CTGTATGGTGT
TCTGTCCAGAA -> CTGTCCAGAAA
TCTGTCCCCGA -> CTGTCCCCGAT
TCTGTTAGGAT -> CTGTTAGGATC
TCTGTTTAGGG -> CTGTTTAGGGT
TCTTATAACAG -> CTTATAACAGC
TCTTATGGACA -> CTTATGGACAG
TCTTCCTTAGT -> CTTCCTTAGTA
TCTTGTACCTA -> CTTGTACCTAG
TCTTGTTGTCA -> CTTGTTGTCAA
TCTTTACATAC -> CTTTACATACT
TCTTTCGGGAC -> CTTTCGGGACT
TGAAAAAATAG -> GAAAAAATAGC
TGAACGAGACA -> GAACGAGACAC
TGAAGGATAGC -> GAAGGATAGCG
TGAATTTGCAG -> GAATTTGCAGT
TGACCGTTGCC -> GACCGTTGCCA
TGAGAATCGTA -> GAGAATCGTAT
TGAGAGACTCC -> GAGAGACTCCC
TGAGCACAGGA -> GAGCACAGGAC
TGAGCACCAGT -> GAGCACCAGTC
TGAGCGTCATG -> GAGCGTCATGG
TGAGGATCCTA -> GAGGATCCTAG
TGAGGTCGCTC -> GAGGTCGCTCA
TGAGTACACGC -> GAGTACACGCC
TGAGTGAGCAC -> GAGTGAGCACC
TGAGTTCATGA -> GAGTTCATGAT
TGAGTTTTCAT -> GAGTTTTCATT
TGATATTCCTA -> GATATTCCTAT
TGATCACGAAT -> GATCACGAATC
TGATCATGATC -> GATCATGATCA
TGATCGAGGAA -> GATCGAGGAAC
TGATGGCTACA -> GATGGCTACAG
TGATTCCGAGA -> GATTCCGAGAT
TGATTGGCACC -> GATTGGCACCG
TGCAAAAATGG -> GCAAAAATGGT
TGCAAGCGCTG -> GCAAGCGCTGT
TGCACCTTATA -> GCACCTTATAT
TGCAGATAGAT -> GCAGATAGATA
TGCAGGCGTCA -> GCAGGCGTCAT
TGCAGTTCAGA -> GCAGTTCAGAG
TGCAGTTTCGT -> GCAGTTTCGTC
TGCATAATAGC -> GCATAATAGCT
TGCATCGACGT -> GCATCGACGTT
TGCATGGATAA -> GCATGGATAAA
TGCCAACCTTC -> GCCAACCTTCG
TGCCATTGTTC -> GCCATTGTTCC
TGCCCAATAAC -> GCCCAATAACC
TGCCCAGTGTC -> GCCCAGTGTCG
TGCCCCGCTCG -> GCCCCGCTCGC
TGCCTATCACT -> GCCTATCACTG
TGCCTTCTCGT -> GCCTTCTCGTG
TGCGAGACCGC -> GCGAGACCGCC
TGCGATCGCTA -> GCGATCGCTAC
TGCGCCGCTTA -> GCGCCGCTTAG
TGCGCTCAGGA -> GCGCTCAGGAA
TGCGGAAGAGA -> GCGGAAGAGAC
TGCGGGACCCA -> GCGGGACCCAA
TGCGTTCAAAT -> GCGTTCAAATG
TGCTAGGTGTC -> GCTAGGTGTCA
TGCTAGTTAAA -> GCTAGTTAAAA
TGCTCAACGGC -> GCTCAACGGCC
TGCTCAGACCC -> GCTCAGACCCA
TGCTGGACTAA -> GCTGGACTAAT
TGCTTAATCCT -> GCTTAATCCTG
TGGAATCCGCA -> GGAATCCGCAG
TGGACACCTGC -> GGACACCTGCC
TGGACAGCGTA -> GGACAGCGTAG
TGGACTAATTC -> GGACTAATTCC
TGGACTCATGT -> GGACTCATGTG
TGGACTCGAAT -> GGACTCGAATC
TGGAGCCACTA -> GGAGCCACTAG
TGGAGGTCATC -> GGAGGTCATCG
TGGATAAATAA -> GGATAAATAAC
TGGATTGAAGG -> GGATTGAAGGA
TGGCACCGGAA -> GGCACCGGAAT
TGGCATCTACG -> GGCATCTACGA
TGGCCACGCAT -> GGCCACGCATA
TGGCCGGTGGA -> GGCCGGTGGAG
TGGCGCGACGG -> GGCGCGACGGG
TGGCGTCCCCT -> GGCGTCCCCTA
TGGCTACAGAC -> GGCTACAGACT
TGGCTACTGTT -> GGCTACTGTTC
TGGCTTACATC -> GGCTTACATCT
TGGGACTTTCG -> GGGACTTTCGG
TGGTACTCGTA -> GGTACTCGTAC
TGGTACTCTTT -> GGTACTCTTTA
TGGTATCAACC -> GGTATCAACCG
TGGTGAGCACA -> GGTGAGCACAG
TGGTGGTACTC -> GGTGGTACTCT
TGGTGTTATAG -> GGTGTTATAGA
TGTAACGGTTA -> GTAACGGTTAT
TGTAATTCATT -> GTAATTCATTT
TGTACCTAGAG -> GTACCTAGAGT
TGTAGACATTG -> GTAGACATTGT
TGTAGAGGTTC -> GTAGAGGTTCA
TGTAGCTTCTT -> GTAGCTTCTTG
TGTAGTCAGTT -> GTAGTCAGTTC
TGTATGGTGTT -> GTATGGTGTTA
TGTCAATAATT -> GTCAATAATTC
TGTCACTCCAA -> GTCACTCCAAA
TGTCACTCGAT -> GTCACTCGATC
TGTCCAGAAAA -> GTCCAGAAAAT
TGTCCAGGAAA -> GTCCAGGAAAT
TGTCCATACCC -> GTCCATACCCA
TGTCCATTTGT -> GTCCATTTGTG
TGTCCCCGATC -> GTCCCCGATCT
TGTCCTGTAGC -> GTCCTGTAGCT
TGTCGCAGACC -> GTCGCAGACCA
TGTCGGATGAA -> GTCGGATGAAT
TGTGATTGGCA -> GTGATTGGCAC
TGTGCATAATA -> GTGCATAATAG
TGTGCATCGAC -> GTGCATCGACG
TGTGCGGGACC -> GTGCGGGACCC
TGTGCTGGACT -> GTGCTGGACTA
TGTGTTCTACG -> GTGTTCTACGA
TGTTAGGATCT -> GTTAGGATCTG
TGTTATAGACT -> GTTATAGACTA
TGTTCAGGGCC -> GTTCAGGGCCA
TGTTCCAAGAA -> GTTCCAAGAAA
TGTTCCAGTGC -> GTTCCAGTGCT
TGTTCCCCGCC -> GTTCCCCGCCA
TGTTCCGTGTC -> GTTCCGTGTCC
TGTTCGGCAAC -> GTTCGGCAACG
TGTTCGGGAGA -> GTTCGGGAGAG
TGTTCTACGAT -> GTTCTACGATG
TGTTCTAGACG -> GTTCTAGACGT
TGTTCTCGAGT -> GTTCTCGAGTT
TGTTGCTAGGT -> GTTGCTAGGTG
TGTTGTCAATA -> GTTGTCAATAA
TGTTGTCCATT -> GTTGTCCATTT
TGTTTAGGGTG -> GTTTAGGGTGC
TGTTTAGTATG -> GTTTAGTATGG
TGTTTGATGGC -> GTTTGATGGCT
TTAAAACCGGG -> TAAAACCGGGC
TTAACTTGAGT -> TAACTTGAGTG
TTAAGCCGTCA -> TAAGCCGTCAA
TTAAGGCCGGC -> TAAGGCCGGCT
TTAATCCTGGC -> TAATCCTGGCA
TTAATTCTGTT -> TAATTCTGTTA
TTACAAGCTGC -> TACAAGCTGCC
TTACATACTGT -> TACATACTGTA
TTACATCTCAT -> TACATCTCATG
TTACTGAGTAC -> TACTGAGTACA
TTAGAATTAGG -> TAGAATTAGGA
TTAGATGGATT -> TAGATGGATTG
TTAGCTGGACT -> TAGCTGGACTC
TTAGGAGCCTT -> TAGGAGCCTTG
TTAGGATCTGT -> TAGGATCTGTA
TTAGGCCGATA -> TAGGCCGATAC
TTAGGCGCGGA -> TAGGCGCGGAT
TTAGGGTGCTA -> TAGGGTGCTAG
TTAGTATGGAG -> TAGTATGGAGG
TTAGTATTTCC -> TAGTATTTCCC
TTATAAAGCCG -> TATAAAGCCGA
TTATAACAGCG -> TATAACAGCGA
TTATAATACTT -> TATAATACTTG
TTATAGACTAA -> TATAGACTAAC
TTATAGGACCT -> TATAGGACCTA
TTATATATCAC -> TATATATCACT
TTATGGACAGC -> TATGGACAGCG
TTATGGTACTC -> TATGGTACTCG
TTATGTTCCAA -> TATGTTCCAAG
TTATTCAATTA -> TATTCAATTAT
TTATTCGCGGG -> TATTCGCGGGA
TTATTTAACTT -> TATTTAACTTG
TTCAAATGCCC -> TCAAATGCCCA
TTCAACGCGGG -> TCAACGCGGGT
TTCAATTATAA -> TCAATTATAAA
TTCACGGGAGG -> TCACGGGAGGA
TTCAGAGAGAT -> TCAGAGAGATG
TTCAGGGCCAG -> TCAGGGCCAGG
TTCATGATTCC -> TCATGATTCCG
TTCATTGCTCA -> TCATTGCTCAG
TTCATTTATGG -> TCATTTATGGT
TTCCAAGAAAT -> TCCAAGAAATG
TTCCAGCAGCC -> TCCAGCAGCCC
TTCCAGTGCTT -> TCCAGTGCTTA
TTCCAGTTCTT -> TCCAGTTCTTT
TTCCATCTAAA -> TCCATCTAAAC
TTCCATGAGTT -> TCCATGAGTTT
TTCCCCGCCAT -> TCCCCGCCATA
TTCCCTTTGTT -> TCCCTTTGTTC
TTCCGAGATAT -> TCCGAGATATA
TTCCGTGTCCA -> TCCGTGTCCAT
TTCCTATTTTA -> TCCTATTTTAA
TTCCTGCACCT -> TCCTGCACCTT
TTCCTTAGTAT -> TCCTTAGTATT
TTCCTTTTCAA -> TCCTTTTCAAC
TTCGATGTTGT -> TCGATGTTGTC
TTCGCAAAAAA -> TCGCAAAAAAG
TTCGCGGGACC -> TCGCGGGACCC
TTCGCGTGCCT -> TCGCGTGCCTT
TTCGGCAACGG -> TCGGCAACGGC
TTCGGGACTAC -> TCGGGACTACC
TTCGGGAGAGA -> TCGGGAGAGAT
TTCGGTCCTGC -> TCGGTCCTGCG
TTCGGTTAGCT -> TCGGTTAGCTG
TTCGTATGTGC -> TCGTATGTGCG
TTCGTCATTCC -> TCGTCATTCCA
TTCTACGATGT -> TCTACGATGTT
TTCTAGACGTC -> TCTAGACGTCC
TTCTATGATCG -> TCTATGATCGA
TTCTCGAGTTA -> TCTCGAGTTAA
TTCTCGTGCTC -> TCTCGTGCTCA
TTCTCTTGTTG -> TCTCTTGTTGT
TTCTGTAGTCA -> TCTGTAGTCAG
TTCTGTTAGGA -> TCTGTTAGGAT
TTCTGTTTAGG -> TCTGTTTAGGG
TTCTTCCTTAG -> TCTTCCTTAGT
TTCTTGTACCT -> TCTTGTACCTA
TTCTTTCGGGA -> TCTTTCGGGAC
TTGAAGGATAG -> TGAAGGATAGC
TTGACCGTTGC -> TGACCGTTGCC
TTGAGAGACTC -> TGAGAGACTCC
TTGAGTGAGCA -> TGAGTGAGCAC
TTGAGTTCATG -> TGAGTTCATGA
TTGATATTCCT -> TGATATTCCTA
TTGATGGCTAC -> TGATGGCTACA
TTGCAAGCGCT -> TGCAAGCGCTG
TTGCAGTTTCG -> TGCAGTTTCGT
TTGCCAACCTT -> TGCCAACCTTC
TTGCGCTCAGG -> TGCGCTCAGGA
TTGCTAGGTGT -> TGCTAGGTGTC
TTGCTCAGACC -> TGCTCAGACCC
TTGGACTCGAA -> TGGACTCGAAT
TTGGCACCGGA -> TGGCACCGGAA
TTGTACCTAGA -> TGTACCTAGAG
TTGTCAATAAT -> TGTCAATAATT
TTGTCCATTTG -> TGTCCATTTGT
TTGTGCATAAT -> TGTGCATAATA
TTGTGCATCGA -> TGTGCATCGAC
TTGTTCAGGGC -> TGTTCAGGGCC
TTGTTCCGTGT -> TGTTCCGTGTC
TTGTTCGGCAA -> TGTTCGGCAAC
TTGTTGTCAAT -> TGTTGTCAATA
TTGTTTAGTAT -> TGTTTAGTATG
TTTAACTTGAG -> TTAACTTGAGT
TTTAAGGCCGG -> TTAAGGCCGGC
TTTACATACTG -> TTACATACTGT
TTTACTGAGTA -> TTACTGAGTAC
TTTAGGGTGCT -> TTAGGGTGCTA
TTTAGTATGGA -> TTAGTATGGAG
TTTATGGTACT -> TTATGGTACTC
TTTATTCAATT -> TTATTCAATTA
TTTATTCGCGG -> TTATTCGCGGG
TTTCAACGCGG -> TTCAACGCGGG
TTTCATTGCTC -> TTCATTGCTCA
TTTCCCTTTGT -> TTCCCTTTGTT
TTTCGGGACTA -> TTCGGGACTAC
TTTCGGTTAGC -> TTCGGTTAGCT
TTTCGTCATTC -> TTCGTCATTCC
TTTGAGAGACT -> TTGAGAGACTC
TTTGATGGCTA -> TTGATGGCTAC
TTTGCAGTTTC -> TTGCAGTTTCG
TTTGTGCATAA -> TTGTGCATAAT
TTTGTTCAGGG -> TTGTTCAGGGC
TTTTAAGGCCG -> TTTAAGGCCGG
TTTTCAACGCG -> TTTCAACGCGG
TTTTCATTGCT -> TTTCATTGCTC
TTTTGAGAGAC -> TTTGAGAGACT